AAH: ctfyrwoiusrxsrkricyrxbyedirmlvcyjxskrmeqfldxyowyktvyjkrijzsf
AAL: ctbyrsoiqsrtsrgriyyrtbyadinmlrcyfxsgrmaqfhdxuowuktryjgrifzsb
AAS: ctuyrloijsrmsrzriryrmbytdigmlkcyyxszrmtqfadxnownktkyjzriyzsu
ABA: csmyqdohbsqesqrrhjyqebxldhymkccxqxrrrllqesdwfovfkscyirrhqzrm
ABO: csyyqpohnsqqsqdrhvyqqbxxdhkmkocxcxrdrlxqeedwrovrksoyidrhczry
ABS: csuyqlohjsqmsqzrhryqmbxtdhgmkkcxyxrzrltqeadwnovnkskyizrhyzru
ABY: csoyqfohdsqgsqtrhlyqgbxndhamkecxsxrtrlnqeudwhovhkseyitrhszro
ACE: criypzogxspaspnrgfypabwhdgumjycwmxqnrkhqdodvboubkryyhnrgmzqi
ACT: crtypkogisplspyrgqyplbwsdgfmjjcwxxqyrksqdzdvmoumkrjyhyrgxzqt
ADD: cqjyoaofysobsoorfgyobbvidfvmizcvnxporjiqcpducotckqzygorfnzpj
ADO: cqyyopofnsoqsodrfvyoqbvxdfkmiocvcxpdrjxqcedurotrkqoygdrfczpy
ADS: cquyolofjsomsozrfryombvtdfgmikcvyxpzrjtqcadunotnkqkygzrfyzpu
ADZ: cqnyoeofcsofsosrfkyofbvmdfzmidcvrxpsrjmqctdugotgkqdygsrfrzpn
AFF: cohymyodwsmzsmmrdeymzbtgddtmgxctlxnmrhgqandsaorakoxyemrdlznh
AFT: cotymkodismlsmyrdqymlbtsddfmgjctxxnyrhsqazdsmormkojyeyrdxznt
AGA: cnmyldocbsleslrrcjylebsldcymfccsqxmrrglqzsdrfoqfkncydrrcqzmm
AGE: cniylzocxslaslnrcfylabshdcumfycsmxmnrghqzodrboqbknyydnrcmzmi
AGO: cnyylpocnslqsldrcvylqbsxdckmfocscxmdrgxqzedrroqrknoyddrcczmy
AGS: cnuyllocjslmslzrcrylmbstdcgmfkcsyxmzrgtqzadrnoqnknkydzrcyzmu
AHA: cmmykdobbskeskrrbjykebrldbymeccrqxlrrflqysdqfopfkmcycrrbqzlm
AHI: cmeykvobtskwskjrbbykwbrddbqmeucrixljrfdqykdqxopxkmuycjrbizle
AHS: cmuyklobjskmskzrbrykmbrtdbgmekcryxlzrftqyadqnopnkmkyczrbyzlu
AID: cljyjaoaysjbsjoragyjbbqidavmdzcqnxkoreiqxpdpcoocklzyboranzkj
AIL: clbyjsoaqsjtsjgrayyjtbqadanmdrcqfxkgreaqxhdpuoouklrybgrafzkb
AIM: clayjroapsjssjfraxyjsbqzdammdqcqexkfrezqxgdptootklqybfraezka
AIN: clzyjqoaosjrsjerawyjrbqydalmdpcqdxkereyqxfdpsoosklpyberadzkz
AIR: clvyjmoaksjnsjarasyjnbqudahmdlcqzxkareuqxbdpooookllybarazzkv
AIS: cluyjloajsjmsjzraryjmbqtdagmdkcqyxkzretqxadpnoonklkybzrayzku
AIT: cltyjkoaisjlsjyraqyjlbqsdafmdjcqxxkyresqxzdpmoomkljybyraxzkt
ALA: cimygdoxbsgesgrrxjygebnldxymaccnqxhrrblqusdmfolfkicyyrrxqzhm
ALB: cilygcoxasgdsgqrxiygdbnkdxxmabcnpxhqrbkqurdmeolekibyyqrxpzhl
ALE: ciiygzoxxsgasgnrxfygabnhdxumaycnmxhnrbhquodmbolbkiyyynrxmzhi
ALL: cibygsoxqsgtsggrxyygtbnadxnmarcnfxhgrbaquhdmuolukiryygrxfzhb
ALP: cixygooxmsgpsgcrxuygpbnwdxjmancnbxhcrbwquddmqolqkinyycrxbzhx
ALS: ciuygloxjsgmsgzrxrygmbntdxgmakcnyxhzrbtquadmnolnkikyyzrxyzhu
ALT: citygkoxisglsgyrxqyglbnsdxfmajcnxxhyrbsquzdmmolmkijyyyrxxzht
AMA: chmyfdowbsfesfrrwjyfebmldwymzccmqxgrralqtsdlfokfkhcyxrrwqzgm
AMI: cheyfvowtsfwsfjrwbyfwbmddwqmzucmixgjradqtkdlxokxkhuyxjrwizge
AMP: chxyfoowmsfpsfcrwuyfpbmwdwjmzncmbxgcrawqtddlqokqkhnyxcrwbzgx
AMU: chsyfjowhsfksfxrwpyfkbmrdwemzicmwxgxrarqtydlloklkhiyxxrwwzgs
ANA: cgmyedovbseeserrvjyeeblldvymycclqxfrrzlqssdkfojfkgcywrrvqzfm
AND: cgjyeaovysebseorvgyebblidvvmyzclnxforziqspdkcojckgzyworvnzfj
ANE: cgiyezovxseasenrvfyeablhdvumyyclmxfnrzhqsodkbojbkgyywnrvmzfi
ANI: cgeyevovtsewsejrvbyewblddvqmyuclixfjrzdqskdkxojxkguywjrvizfe
ANT: cgtyekoviselseyrvqyelblsdvfmyjclxxfyrzsqszdkmojmkgjywyrvxzft
ANY: cgoyefovdsegsetrvlyegblndvamyeclsxftrznqsudkhojhkgeywtrvszfo
APE: ceiyczotxscascnrtfycabjhdtumwycjmxdnrxhqqodibohbkeyyunrtmzdi
APO: ceyycpotnscqscdrtvycqbjxdtkmwocjcxddrxxqqedirohrkeoyudrtczdy
APP: cexycootmscpsccrtuycpbjwdtjmwncjbxdcrxwqqddiqohqkenyucrtbzdx
APT: cetyckotisclscyrtqyclbjsdtfmwjcjxxdyrxsqqzdimohmkejyuyrtxzdt
ARB: cclyacorasadsaqrriyadbhkdrxmubchpxbqrvkqordgeofekcbysqrrpzbl
ARC: cckyaborzsacsaprrhyacbhjdrwmuachoxbprvjqoqdgdofdkcaysprrozbk
ARE: cciyazorxsaasanrrfyaabhhdrumuychmxbnrvhqoodgbofbkcyysnrrmzbi
ARF: cchyayorwsazsamrreyazbhgdrtmuxchlxbmrvgqondgaofakcxysmrrlzbh
ARK: cccyatorrsausahrrzyaubhbdromuschgxbhrvbqoidgvofvkcsyshrrgzbc
ARM: ccayarorpsassafrrxyasbhzdrmmuqchexbfrvzqogdgtoftkcqysfrrezba
ARS: ccuyalorjsamsazrrryambhtdrgmukchyxbzrvtqoadgnofnkckyszrryzbu
ART: cctyakorisalsayrrqyalbhsdrfmujchxxbyrvsqozdgmofmkcjysyrrxzbt
ASH: cbfyzwoquszxszkrqcyzxbgedqrmtvcgjxakrueqnldfyoeykbvyrkrqjzaf
ASK: cbcyztoqrszuszhrqzyzubgbdqomtscggxahrubqnidfvoevkbsyrhrqgzac
ASP: cbxyzooqmszpszcrquyzpbgwdqjmtncgbxacruwqnddfqoeqkbnyrcrqbzax
ASS: cbuyzloqjszmszzrqryzmbgtdqgmtkcgyxazrutqnadfnoenkbkyrzrqyzau
ATE: caiyyzopxsyasynrpfyyabfhdpumsycfmxznrthqmodebodbkayyqnrpmzzi
ATT: catyykopisylsyyrpqyylbfsdpfmsjcfxxzyrtsqmzdemodmkajyqyrpxzzt
AUK: czcyxtoorsxusxhrozyxubebdoomrscegxyhrsbqliddvocvkzsyphrogzyc
AVA: cymywdonbsweswrrnjywebdldnymqccdqxxrrrlqksdcfobfkycyorrnqzxm
AVE: cyiywzonxswaswnrnfywabdhdnumqycdmxxnrrhqkodcbobbkyyyonrnmzxi
AVO: cyyywponnswqswdrnvywqbdxdnkmqocdcxxdrrxqkedcrobrkyoyodrnczxy
AWA: cxmyvdombsvesvrrmjyvebcldmympcccqxwrrqlqjsdbfoafkxcynrrmqzwm
AWE: cxiyvzomxsvasvnrmfyvabchdmumpyccmxwnrqhqjodbboabkxyynnrmmzwi
AWL: cxbyvsomqsvtsvgrmyyvtbcadmnmprccfxwgrqaqjhdbuoaukxryngrmfzwb
AWN: cxzyvqomosvrsvermwyvrbcydmlmppccdxwerqyqjfdbsoaskxpynermdzwz
AXE: cwiyuzolxsuasunrlfyuabbhdlumoycbmxvnrphqiodabozbkwyymnrlmzvi
AYE: cviytzokxstastnrkfytabahdkumnycamxunrohqhodzboybkvyylnrkmzui
AYS: cvuytlokjstmstzrkrytmbatdkgmnkcayxuzrotqhadznoynkvkylzrkyzuu
AZO: cuyyspojnssqssdrjvysqbzxdjkmmoczcxtdrnxqgedyroxrkuoykdrjczty
BAA: btmxrdnibrrerrrqijxreaylciyllcbyqwsrqmlpfscxfnwfjtcxjrqiqysm
BAD: btjxraniyrrbrroqigxrbayicivllzbynwsoqmipfpcxcnwcjtzxjoqinysj
BAG: btgxrxnivrryrrlqidxryayfcisllwbykwslqmfpfmcxznwzjtwxjlqikysg
BAH: btfxrwniurrxrrkqicxrxayecirllvbyjwskqmepflcxynwyjtvxjkqijysf
BAL: btbxrsniqrrtrrgqiyxrtayacinllrbyfwsgqmapfhcxunwujtrxjgqifysb
BAM: btaxrrniprrsrrfqixxrsayzcimllqbyewsfqmzpfgcxtnwtjtqxjfqieysa
BAN: btzxrqniorrrrreqiwxrrayycilllpbydwseqmypffcxsnwsjtpxjeqidysz
BAP: btxxronimrrprrcqiuxrpaywcijllnbybwscqmwpfdcxqnwqjtnxjcqibysx
BAR: btvxrmnikrrnrraqisxrnayucihlllbyzwsaqmupfbcxonwojtlxjaqizysv
BAS: btuxrlnijrrmrrzqirxrmaytcigllkbyywszqmtpfacxnnwnjtkxjzqiyysu
BAT: bttxrkniirrlrryqiqxrlaysciflljbyxwsyqmspfzcxmnwmjtjxjyqixyst
BAY: btoxrfnidrrgrrtqilxrgaynciallebyswstqmnpfucxhnwhjtexjtqisyso
BED: bpjxnaneyrnbrnoqegxnbauicevlhzbunwooqiipbpctcnscjpzxfoqenyoj
BEE: bpixnznexrnarnnqefxnaauhceulhybumwonqihpboctbnsbjpyxfnqemyoi
BEG: bpgxnxnevrnyrnlqedxnyaufceslhwbukwolqifpbmctznszjpwxflqekyog
BEL: bpbxnsneqrntrngqeyxntauacenlhrbufwogqiapbhctunsujprxfgqefyob
BEN: bpzxnqneornrrneqewxnrauycellhpbudwoeqiypbfctsnssjppxfeqedyoz
BES: bpuxnlnejrnmrnzqerxnmautceglhkbuywozqitpbactnnsnjpkxfzqeyyou
BET: bptxnkneirnlrnyqeqxnlausceflhjbuxwoyqispbzctmnsmjpjxfyqexyot
BEY: bpoxnfnedrngrntqelxngauncealhebuswotqinpbucthnshjpexftqesyoo
BIB: bllxjcnaarjdrjqqaixjdaqkcaxldbbqpwkqqekpxrcpenoejlbxbqqapykl
BID: bljxjanayrjbrjoqagxjbaqicavldzbqnwkoqeipxpcpcnocjlzxboqanykj
BIG: blgxjxnavrjyrjlqadxjyaqfcasldwbqkwklqefpxmcpznozjlwxblqakykg
BIN: blzxjqnaorjrrjeqawxjraqycalldpbqdwkeqeypxfcpsnosjlpxbeqadykz
BIO: blyxjpnanrjqrjdqavxjqaqxcakldobqcwkdqexpxecprnorjloxbdqacyky
BIS: bluxjlnajrjmrjzqarxjmaqtcagldkbqywkzqetpxacpnnonjlkxbzqayyku
BIT: bltxjknairjlrjyqaqxjlaqscafldjbqxwkyqespxzcpmnomjljxbyqaxykt
BIZ: blnxjenacrjfrjsqakxjfaqmcazlddbqrwksqempxtcpgnogjldxbsqarykn
BOA: bfmxddnubrderdrqujxdeaklcuylxcbkqwerqylprscjfnifjfcxvrquqyem
BOB: bflxdcnuarddrdqquixddakkcuxlxbbkpweqqykprrcjeniejfbxvqqupyel
BOD: bfjxdanuyrdbrdoqugxdbakicuvlxzbknweoqyiprpcjcnicjfzxvoqunyej
BOG: bfgxdxnuvrdyrdlqudxdyakfcuslxwbkkwelqyfprmcjznizjfwxvlqukyeg
BOO: bfyxdpnunrdqrddquvxdqakxcuklxobkcwedqyxprecjrnirjfoxvdqucyey
BOP: bfxxdonumrdprdcquuxdpakwcujlxnbkbwecqywprdcjqniqjfnxvcqubyex
BOS: bfuxdlnujrdmrdzqurxdmaktcuglxkbkywezqytpracjnninjfkxvzquyyeu
BOT: bftxdknuirdlrdyquqxdlakscuflxjbkxweyqysprzcjmnimjfjxvyquxyet
BOW: bfqxdhnufrdirdvqunxdiakpcuclxgbkuwevqypprwcjjnijjfgxvvquuyeq
BOX: bfpxdgnuerdhrduqumxdhakocublxfbktweuqyoprvcjiniijffxvuqutyep
BOY: bfoxdfnudrdgrdtqulxdgakncualxebkswetqynprucjhnihjfexvtqusyeo
BRA: bcmxadnrbraerarqrjxaeahlcrylucbhqwbrqvlposcgfnffjccxsrqrqybm
BRO: bcyxapnrnraqradqrvxaqahxcrkluobhcwbdqvxpoecgrnfrjcoxsdqrcyby
BRR: bcvxamnrkranraaqrsxanahucrhlulbhzwbaqvupobcgonfojclxsaqrzybv
BUB: bzlxxcnoarxdrxqqoixxdaekcoxlrbbepwyqqskplrcdencejzbxpqqopyyl
BUD: bzjxxanoyrxbrxoqogxxbaeicovlrzbenwyoqsiplpcdcnccjzzxpoqonyyj
BUG: bzgxxxnovrxyrxlqodxxyaefcoslrwbekwylqsfplmcdznczjzwxplqokyyg
BUM: bzaxxrnoprxsrxfqoxxxsaezcomlrqbeewyfqszplgcdtnctjzqxpfqoeyya
BUN: bzzxxqnoorxrrxeqowxxraeycollrpbedwyeqsyplfcdsncsjzpxpeqodyyz
BUR: bzvxxmnokrxnrxaqosxxnaeucohlrlbezwyaqsuplbcdoncojzlxpaqozyyv
BUS: bzuxxlnojrxmrxzqorxxmaetcoglrkbeywyzqstplacdnncnjzkxpzqoyyyu
BUT: bztxxknoirxlrxyqoqxxlaescoflrjbexwyyqssplzcdmncmjzjxpyqoxyyt
BUY: bzoxxfnodrxgrxtqolxxgaencoalrebeswytqsnplucdhnchjzexptqosyyo
BYE: bvixtznkxrtartnqkfxtaaahckulnybamwunqohphoczbnybjvyxlnqkmyui
BYS: bvuxtlnkjrtmrtzqkrxtmaatckglnkbaywuzqotphacznnynjvkxlzqkyyuu
CAB: atlwrcmiaqrdqrqpiiwrdzykbixklbaypvsqpmkofrbxemweitbwjqpipxsl
CAD: atjwramiyqrbqropigwrbzyibivklzaynvsopmiofpbxcmwcitzwjopinxsj
CAM: atawrrmipqrsqrfpixwrszyzbimklqayevsfpmzofgbxtmwtitqwjfpiexsa
CAN: atzwrqmioqrrqrepiwwrrzyybilklpaydvsepmyoffbxsmwsitpwjepidxsz
CAP: atxwromimqrpqrcpiuwrpzywbijklnaybvscpmwofdbxqmwqitnwjcpibxsx
CAR: atvwrmmikqrnqrapiswrnzyubihkllayzvsapmuofbbxomwoitlwjapizxsv
CAT: attwrkmiiqrlqrypiqwrlzysbifkljayxvsypmsofzbxmmwmitjwjypixxst
CAW: atqwrhmifqriqrvpinwrizypbicklgayuvsvpmpofwbxjmwjitgwjvpiuxsq
CAY: atowrfmidqrgqrtpilwrgzynbiakleaysvstpmnofubxhmwhitewjtpisxso
CEE: apiwnzmexqnaqnnpefwnazuhbeukhyaumvonpihobobtbmsbipywfnpemxoi
CEL: apbwnsmeqqntqngpeywntzuabenkhraufvogpiaobhbtumsuiprwfgpefxob
CEP: apxwnomemqnpqncpeuwnpzuwbejkhnaubvocpiwobdbtqmsqipnwfcpebxox
CHI: amewkvmbtqkwqkjpbbwkwzrdbbqkeuarivljpfdoykbqxmpximuwcjpbixle
CIG: algwjxmavqjyqjlpadwjyzqfbaskdwaqkvklpefoxmbpzmozilwwblpakxkg
CIS: aluwjlmajqjmqjzparwjmzqtbagkdkaqyvkzpetoxabpnmonilkwbzpayxku
COB: aflwdcmuaqddqdqpuiwddzkkbuxkxbakpveqpykorrbjemieifbwvqpupxel
COD: afjwdamuyqdbqdopugwdbzkibuvkxzaknveopyiorpbjcmicifzwvopunxej
COG: afgwdxmuvqdyqdlpudwdyzkfbuskxwakkvelpyformbjzmizifwwvlpukxeg
COL: afbwdsmuqqdtqdgpuywdtzkabunkxrakfvegpyaorhbjumiuifrwvgpufxeb
CON: afzwdqmuoqdrqdepuwwdrzkybulkxpakdveepyyorfbjsmisifpwvepudxez
COO: afywdpmunqdqqddpuvwdqzkxbukkxoakcvedpyxorebjrmirifowvdpucxey
COP: afxwdomumqdpqdcpuuwdpzkwbujkxnakbvecpywordbjqmiqifnwvcpubxex
COR: afvwdmmukqdnqdapuswdnzkubuhkxlakzveapyuorbbjomioiflwvapuzxev
COS: afuwdlmujqdmqdzpurwdmzktbugkxkakyvezpytorabjnminifkwvzpuyxeu
COT: aftwdkmuiqdlqdypuqwdlzksbufkxjakxveypysorzbjmmimifjwvypuxxet
COW: afqwdhmufqdiqdvpunwdizkpbuckxgakuvevpyporwbjjmijifgwvvpuuxeq
COX: afpwdgmueqdhqdupumwdhzkobubkxfaktveupyoorvbjimiiiffwvuputxep
COY: afowdfmudqdgqdtpulwdgzknbuakxeaksvetpynorubjhmihifewvtpusxeo
COZ: afnwdemucqdfqdspukwdfzkmbuzkxdakrvespymortbjgmigifdwvspurxen
CRU: acswajmrhqakqaxprpwakzhrbrekuiahwvbxpvrooybglmfliciwsxprwxbs
CRY: acowafmrdqagqatprlwagzhnbrakueahsvbtpvnooubghmfhicewstprsxbo
CUB: azlwxcmoaqxdqxqpoiwxdzekboxkrbaepvyqpskolrbdemceizbwpqpopxyl
CUD: azjwxamoyqxbqxopogwxbzeibovkrzaenvyopsiolpbdcmccizzwpoponxyj
CUE: aziwxzmoxqxaqxnpofwxazehboukryaemvynpsholobdbmcbizywpnpomxyi
CUM: azawxrmopqxsqxfpoxwxszezbomkrqaeevyfpszolgbdtmctizqwpfpoexya
CUP: azxwxomomqxpqxcpouwxpzewbojkrnaebvycpswoldbdqmcqiznwpcpobxyx
CUR: azvwxmmokqxnqxaposwxnzeubohkrlaezvyapsuolbbdomcoizlwpapozxyv
CUT: aztwxkmoiqxlqxypoqwxlzesbofkrjaexvyypssolzbdmmcmizjwpypoxxyt
CWM: axawvrmmpqvsqvfpmxwvszczbmmkpqacevwfpqzojgbbtmatixqwnfpmexwa
DAB: ztlvrcliaprdprqoiivrdyykaixjlbzypusqomknfraxelwehtbvjqoipwsl
DAD: ztjvraliyprbprooigvrbyyiaivjlzzynusoominfpaxclwchtzvjooinwsj
DAG: ztgvrxlivpryprloidvryyyfaisjlwzykuslomfnfmaxzlwzhtwvjloikwsg
DAH: ztfvrwliuprxprkoicvrxyyeairjlvzyjuskomenflaxylwyhtvvjkoijwsf
DAK: ztcvrtlirpruprhoizvruyybaiojlszygushombnfiaxvlwvhtsvjhoigwsc
DAL: ztbvrsliqprtprgoiyvrtyyaainjlrzyfusgomanfhaxulwuhtrvjgoifwsb
DAM: ztavrrlipprsprfoixvrsyyzaimjlqzyeusfomznfgaxtlwthtqvjfoiewsa
DAN: ztzvrqlioprrpreoiwvrryyyailjlpzyduseomynffaxslwshtpvjeoidwsz
DAP: ztxvrolimprpprcoiuvrpyywaijjlnzybuscomwnfdaxqlwqhtnvjcoibwsx
DAW: ztqvrhlifpriprvoinvriyypaicjlgzyuusvompnfwaxjlwjhtgvjvoiuwsq
DAY: ztovrflidprgprtoilvrgyynaiajlezysustomnnfuaxhlwhhtevjtoiswso
DEB: zplvncleapndpnqoeivndyukaexjhbzupuoqoiknbratelsehpbvfqoepwol
DEE: zpivnzlexpnapnnoefvnayuhaeujhyzumuonoihnboatblsbhpyvfnoemwoi
DEF: zphvnylewpnzpnmoeevnzyugaetjhxzuluomoignbnatalsahpxvfmoelwoh
DEL: zpbvnsleqpntpngoeyvntyuaaenjhrzufuogoianbhatulsuhprvfgoefwob
DEN: zpzvnqleopnrpneoewvnryuyaeljhpzuduoeoiynbfatslsshppvfeoedwoz
DEV: zprvnilegpnjpnwoeovnjyuqaedjhhzuvuowoiqnbxatklskhphvfwoevwor
DEW: zpqvnhlefpnipnvoenvniyupaecjhgzuuuovoipnbwatjlsjhpgvfvoeuwoq
DEX: zppvngleepnhpnuoemvnhyuoaebjhfzutuouoionbvatilsihpfvfuoetwop
DEY: zpovnfledpngpntoelvngyunaeajhezusuotoinnbuathlshhpevftoeswoo
DIB: zllvjclaapjdpjqoaivjdyqkaaxjdbzqpukqoeknxrapeloehlbvbqoapwkl
DID: zljvjalaypjbpjooagvjbyqiaavjdzzqnukooeinxpapclochlzvbooanwkj
DIE: zlivjzlaxpjapjnoafvjayqhaaujdyzqmuknoehnxoapblobhlyvbnoamwki
DIF: zlhvjylawpjzpjmoaevjzyqgaatjdxzqlukmoegnxnapaloahlxvbmoalwkh
DIG: zlgvjxlavpjypjloadvjyyqfaasjdwzqkukloefnxmapzlozhlwvbloakwkg
DIM: zlavjrlappjspjfoaxvjsyqzaamjdqzqeukfoeznxgaptlothlqvbfoaewka
DIN: zlzvjqlaopjrpjeoawvjryqyaaljdpzqdukeoeynxfapsloshlpvbeoadwkz
DIP: zlxvjolampjppjcoauvjpyqwaajjdnzqbukcoewnxdapqloqhlnvbcoabwkx
DIS: zluvjllajpjmpjzoarvjmyqtaagjdkzqyukzoetnxaapnlonhlkvbzoaywku
DIT: zltvjklaipjlpjyoaqvjlyqsaafjdjzqxukyoesnxzapmlomhljvbyoaxwkt
DOC: zfkvdbluzpdcpdpouhvdcykjauwjxazkouepoyjnrqajdlidhfavvpouowek
DOE: zfivdzluxpdapdnoufvdaykhauujxyzkmuenoyhnroajblibhfyvvnoumwei
DOG: zfgvdxluvpdypdloudvdyykfausjxwzkkueloyfnrmajzlizhfwvvloukweg
DOL: zfbvdsluqpdtpdgouyvdtykaaunjxrzkfuegoyanrhajuliuhfrvvgoufweb
DOM: zfavdrluppdspdfouxvdsykzaumjxqzkeuefoyznrgajtlithfqvvfouewea
DON: zfzvdqluopdrpdeouwvdrykyauljxpzkdueeoyynrfajslishfpvveoudwez
DOR: zfvvdmlukpdnpdaousvdnykuauhjxlzkzueaoyunrbajoliohflvvaouzwev
DOS: zfuvdllujpdmpdzourvdmyktaugjxkzkyuezoytnraajnlinhfkvvzouyweu
DOT: zftvdkluipdlpdyouqvdlyksaufjxjzkxueyoysnrzajmlimhfjvvyouxwet
DOW: zfqvdhlufpdipdvounvdiykpaucjxgzkuuevoypnrwajjlijhfgvvvouuweq
DRY: zcovaflrdpagpatorlvagyhnarajuezhsubtovnnouaghlfhhcevstorswbo
DUB: zzlvxcloapxdpxqooivxdyekaoxjrbzepuyqosknlradelcehzbvpqoopwyl
DUD: zzjvxaloypxbpxooogvxbyeiaovjrzzenuyoosinlpadclcchzzvpooonwyj
DUE: zzivxzloxpxapxnoofvxayehaoujryzemuynoshnloadblcbhzyvpnoomwyi
DUG: zzgvxxlovpxypxloodvxyyefaosjrwzekuylosfnlmadzlczhzwvplookwyg
DUH: zzfvxwloupxxpxkoocvxxyeeaorjrvzejuykosenlladylcyhzvvpkoojwyf
DUI: zzevxvlotpxwpxjoobvxwyedaoqjruzeiuyjosdnlkadxlcxhzuvpjooiwye
DUN: zzzvxqloopxrpxeoowvxryeyaoljrpzeduyeosynlfadslcshzpvpeoodwyz
DUO: zzyvxplonpxqpxdoovvxqyexaokjrozecuydosxnleadrlcrhzovpdoocwyy
DUP: zzxvxolompxppxcoouvxpyewaojjrnzebuycoswnldadqlcqhznvpcoobwyx
DYE: zvivtzlkxptaptnokfvtayahakujnyzamuunoohnhoazblybhvyvlnokmwui
EAR: ytvurmkikornoranisurnxyuzihillyyztsanmumfbzxokwogtlujanizvsv
EAT: ytturkkiiorloryniqurlxyszifiljyyxtsynmsmfzzxmkwmgtjujynixvst
EAU: ytsurjkihorkorxnipurkxyrzieiliyywtsxnmrmfyzxlkwlgtiujxniwvss
EBB: ysluqckhaoqdoqqnhiuqdxxkzhxikbyxptrqnlkmerzwekvegsbuiqnhpvrl
ECU: yrsupjkghopkopxngpupkxwrzgeijiywwtqxnkrmdyzvlkulgriuhxngwvqs
EDH: yqfuowkfuooxooknfcuoxxvezfriivyvjtpknjemclzuyktygqvugknfjvpf
EDS: yquuolkfjoomooznfruomxvtzfgiikyvytpznjtmcazunktngqkugznfyvpu
EEK: ypcuntkeronuonhnezunuxubzeoihsyugtohnibmbiztvksvgpsufhnegvoc
EEL: ypbunskeqontongneyuntxuazenihryuftogniambhztuksugprufgnefvob
EFF: yohumykdwomzommndeumzxtgzdtigxytltnmnhgmanzsakragoxuemndlvnh
EFS: youumlkdjommomzndrummxttzdgigkytytnznhtmaazsnkrngokuezndyvnu
EFT: yotumkkdiomlomyndqumlxtszdfigjytxtnynhsmazzsmkrmgojueyndxvnt
EGG: yngulxkcvolyollncdulyxsfzcsifwysktmlngfmzmzrzkqzgnwudlnckvmg
EGO: ynyulpkcnolqoldncvulqxsxzckifoysctmdngxmzezrrkqrgnouddnccvmy
EKE: yjiuhzkyxohaohnnyfuhaxohzyuibyyomtinnchmvoznbkmbgjyuznnymvii
ELD: yijugakxyogbogonxgugbxnizxviazynnthonbimupzmcklcgizuyonxnvhj
ELF: yihugykxwogzogmnxeugzxngzxtiaxynlthmnbgmunzmaklagixuymnxlvhh
ELK: yicugtkxroguoghnxzuguxnbzxoiasyngthhnbbmuizmvklvgisuyhnxgvhc
ELL: yibugskxqogtoggnxyugtxnazxniarynfthgnbamuhzmuklugiruygnxfvhb
ELM: yiaugrkxpogsogfnxxugsxnzzxmiaqynethfnbzmugzmtkltgiquyfnxevha
ELS: yiuuglkxjogmogznxrugmxntzxgiakynythznbtmuazmnklngikuyznxyvhu
EME: yhiufzkwxofaofnnwfufaxmhzwuizyymmtgnnahmtozlbkkbghyuxnnwmvgi
EMS: yhuuflkwjofmofznwrufmxmtzwgizkymytgznatmtazlnkknghkuxznwyvgu
EMU: yhsufjkwhofkofxnwpufkxmrzweiziymwtgxnarmtyzllkklghiuxxnwwvgs
END: ygjueakvyoeboeonvguebxlizvviyzylntfonzimspzkckjcggzuwonvnvfj
ENG: ygguexkvvoeyoelnvdueyxlfzvsiywylktflnzfmsmzkzkjzggwuwlnvkvfg
ENS: yguuelkvjoemoeznvruemxltzvgiykylytfznztmsazknkjnggkuwznvyvfu
EON: yfzudqkuoodrodenuwudrxkyzulixpykdteenyymrfzjskisgfpuvenudvez
ERA: ycmuadkrboaeoarnrjuaexhlzryiucyhqtbrnvlmoszgfkffgccusrnrqvbm
ERE: yciuazkrxoaaoannrfuaaxhhzruiuyyhmtbnnvhmoozgbkfbgcyusnnrmvbi
ERG: ycguaxkrvoayoalnrduayxhfzrsiuwyhktblnvfmomzgzkfzgcwuslnrkvbg
ERN: yczuaqkrooaroaenrwuarxhyzrliupyhdtbenvymofzgskfsgcpusenrdvbz
ERR: ycvuamkrkoanoaanrsuanxhuzrhiulyhztbanvumobzgokfogclusanrzvbv
ERS: ycuualkrjoamoaznrruamxhtzrgiukyhytbznvtmoazgnkfngckusznryvbu
ESS: ybuuzlkqjozmozznqruzmxgtzqgitkygytaznutmnazfnkengbkurznqyvau
ETA: yamuydkpboyeoyrnpjuyexflzpyiscyfqtzrntlmmszefkdfgacuqrnpqvzm
ETH: yafuywkpuoyxoyknpcuyxxfezprisvyfjtzkntemmlzeykdygavuqknpjvzf
EVE: yyiuwzknxowaownnnfuwaxdhznuiqyydmtxnnrhmkozcbkbbgyyuonnnmvxi
EWE: yxiuvzkmxovaovnnmfuvaxchzmuipyycmtwnnqhmjozbbkabgxyunnnmmvwi
EYE: yviutzkkxotaotnnkfutaxahzkuinyyamtunnohmhozzbkybgvyulnnkmvui
FAB: xtltrcjianrdnrqmiitrdwykyixhlbxypssqmmklfryxejweftbtjqmipusl
FAD: xtjtrajiynrbnromigtrbwyiyivhlzxynssommilfpyxcjwcftztjominusj
FAG: xtgtrxjivnrynrlmidtrywyfyishlwxyksslmmflfmyxzjwzftwtjlmikusg
FAN: xtztrqjionrrnremiwtrrwyyyilhlpxydssemmylffyxsjwsftptjemidusz
FAR: xtvtrmjiknrnnramistrnwyuyihhllxyzssammulfbyxojwoftltjamizusv
FAS: xtutrljijnrmnrzmirtrmwytyighlkxyysszmmtlfayxnjwnftktjzmiyusu
FAT: xtttrkjiinrlnrymiqtrlwysyifhljxyxssymmslfzyxmjwmftjtjymixust
FAX: xtptrgjienrhnrumimtrhwyoyibhlfxytssummolfvyxijwiftftjumitusp
FAY: xtotrfjidnrgnrtmiltrgwynyiahlexyssstmmnlfuyxhjwhftetjtmisuso
FED: xpjtnajeynnbnnomegtnbwuiyevhhzxunsoomiilbpytcjscfpztfomenuoj
FEE: xpitnzjexnnannnmeftnawuhyeuhhyxumsonmihlboytbjsbfpytfnmemuoi
FEH: xpftnwjeunnxnnkmectnxwueyerhhvxujsokmielblytyjsyfpvtfkmejuof
FEM: xpatnrjepnnsnnfmextnswuzyemhhqxuesofmizlbgyttjstfpqtffmeeuoa
FEN: xpztnqjeonnrnnemewtnrwuyyelhhpxudsoemiylbfytsjssfpptfemeduoz
FER: xpvtnmjeknnnnnamestnnwuuyehhhlxuzsoamiulbbytojsofpltfamezuov
FES: xputnljejnnmnnzmertnmwutyeghhkxuysozmitlbaytnjsnfpktfzmeyuou
FET: xpttnkjeinnlnnymeqtnlwusyefhhjxuxsoymislbzytmjsmfpjtfymexuot
FEU: xpstnjjehnnknnxmeptnkwuryeehhixuwsoxmirlbyytljslfpitfxmewuos
FEW: xpqtnhjefnninnvmentniwupyechhgxuusovmiplbwytjjsjfpgtfvmeuuoq
FEY: xpotnfjednngnntmeltngwunyeahhexussotminlbuythjshfpetftmesuoo
FEZ: xpntnejecnnfnnsmektnfwumyezhhdxursosmimlbtytgjsgfpdtfsmeruon
FIB: xlltjcjaanjdnjqmaitjdwqkyaxhdbxqpskqmeklxrypejoeflbtbqmapukl
FID: xljtjajaynjbnjomagtjbwqiyavhdzxqnskomeilxpypcjocflztbomanukj
FIE: xlitjzjaxnjanjnmaftjawqhyauhdyxqmsknmehlxoypbjobflytbnmamuki
FIG: xlgtjxjavnjynjlmadtjywqfyashdwxqksklmeflxmypzjozflwtblmakukg
FIL: xlbtjsjaqnjtnjgmaytjtwqayanhdrxqfskgmealxhypujouflrtbgmafukb
FIN: xlztjqjaonjrnjemawtjrwqyyalhdpxqdskemeylxfypsjosflptbemadukz
FIR: xlvtjmjaknjnnjamastjnwquyahhdlxqzskameulxbypojooflltbamazukv
FIT: xlttjkjainjlnjymaqtjlwqsyafhdjxqxskymeslxzypmjomfljtbymaxukt
FIX: xlptjgjaenjhnjumamtjhwqoyabhdfxqtskumeolxvypijoiflftbumatukp
FIZ: xlntjejacnjfnjsmaktjfwqmyazhddxqrsksmemlxtypgjogfldtbsmarukn
FLU: xistgjjxhngkngxmxptgkwnryxehaixnwshxmbrluyymljllfiityxmxwuhs
FLY: xiotgfjxdnggngtmxltggwnnyxahaexnsshtmbnluuymhjlhfietytmxsuho
FOB: xfltdcjuanddndqmuitddwkkyuxhxbxkpseqmyklrryjejieffbtvqmupuel
FOE: xfitdzjuxndandnmuftdawkhyuuhxyxkmsenmyhlroyjbjibffytvnmumuei
FOG: xfgtdxjuvndyndlmudtdywkfyushxwxkkselmyflrmyjzjizffwtvlmukueg
FOH: xfftdwjuundxndkmuctdxwkeyurhxvxkjsekmyelrlyjyjiyffvtvkmujuef
FON: xfztdqjuondrndemuwtdrwkyyulhxpxkdseemyylrfyjsjisffptvemuduez
FOP: xfxtdojumndpndcmuutdpwkwyujhxnxkbsecmywlrdyjqjiqffntvcmubuex
FOR: xfvtdmjukndnndamustdnwkuyuhhxlxkzseamyulrbyjojioffltvamuzuev
FOU: xfstdjjuhndkndxmuptdkwkryuehxixkwsexmyrlryyjljilffitvxmuwues
FOX: xfptdgjuendhndumumtdhwkoyubhxfxktseumyolrvyjijiiffftvumutuep
FOY: xfotdfjudndgndtmultdgwknyuahxexkssetmynlruyjhjihffetvtmusueo
FRO: xcytapjrnnaqnadmrvtaqwhxyrkhuoxhcsbdmvxloeygrjfrfcotsdmrcuby
FRY: xcotafjrdnagnatmrltagwhnyrahuexhssbtmvnlouyghjfhfcetstmrsubo
FUB: xzltxcjoanxdnxqmoitxdwekyoxhrbxepsyqmskllrydejcefzbtpqmopuyl
FUD: xzjtxajoynxbnxomogtxbweiyovhrzxensyomsillpydcjccfzztpomonuyj
FUG: xzgtxxjovnxynxlmodtxywefyoshrwxeksylmsfllmydzjczfzwtplmokuyg
FUN: xzztxqjoonxrnxemowtxrweyyolhrpxedsyemsyllfydsjcsfzptpemoduyz
FUR: xzvtxmjoknxnnxamostxnweuyohhrlxezsyamsullbydojcofzltpamozuyv
GAB: wtlsrciiamrdmrqliisrdvykxixglbwyprsqlmkkfrxxeiweetbsjqliptsl
GAD: wtjsraiiymrbmroligsrbvyixivglzwynrsolmikfpxxciwcetzsjolintsj
GAE: wtisrziixmramrnlifsravyhxiuglywymrsnlmhkfoxxbiwbetysjnlimtsi
GAG: wtgsrxiivmrymrllidsryvyfxisglwwykrsllmfkfmxxziwzetwsjlliktsg
GAL: wtbsrsiiqmrtmrgliysrtvyaxinglrwyfrsglmakfhxxuiwuetrsjgliftsb
GAM: wtasrriipmrsmrflixsrsvyzximglqwyersflmzkfgxxtiwtetqsjflietsa
GAN: wtzsrqiiomrrmreliwsrrvyyxilglpwydrselmykffxxsiwsetpsjelidtsz
GAP: wtxsroiimmrpmrcliusrpvywxijglnwybrsclmwkfdxxqiwqetnsjclibtsx
GAR: wtvsrmiikmrnmralissrnvyuxihgllwyzrsalmukfbxxoiwoetlsjaliztsv
GAS: wtusrliijmrmmrzlirsrmvytxigglkwyyrszlmtkfaxxniwnetksjzliytsu
GAT: wttsrkiiimrlmryliqsrlvysxifgljwyxrsylmskfzxxmiwmetjsjylixtst
GAY: wtosrfiidmrgmrtlilsrgvynxiaglewysrstlmnkfuxxhiwhetesjtlistso
GED: wpjsnaieymnbmnolegsnbvuixevghzwunrooliikbpxtciscepzsfolentoj
GEE: wpisnziexmnamnnlefsnavuhxeughywumronlihkboxtbisbepysfnlemtoi
GEL: wpbsnsieqmntmngleysntvuaxenghrwufrogliakbhxtuisueprsfgleftob
GEM: wpasnriepmnsmnflexsnsvuzxemghqwueroflizkbgxttistepqsffleetoa
GEN: wpzsnqieomnrmnelewsnrvuyxelghpwudroeliykbfxtsisseppsfeledtoz
GET: wptsnkieimnlmnyleqsnlvusxefghjwuxroyliskbzxtmismepjsfylextot
GEY: wposnfiedmngmntlelsngvunxeaghewusrotlinkbuxthishepesftlestoo
GHI: wmeskvibtmkwmkjlbbskwvrdxbqgeuwrirljlfdkykxqxipxemuscjlbitle
GIB: wllsjciaamjdmjqlaisjdvqkxaxgdbwqprkqlekkxrxpeioeelbsbqlaptkl
GID: wljsjaiaymjbmjolagsjbvqixavgdzwqnrkoleikxpxpciocelzsbolantkj
GIE: wlisjziaxmjamjnlafsjavqhxaugdywqmrknlehkxoxpbiobelysbnlamtki
GIG: wlgsjxiavmjymjlladsjyvqfxasgdwwqkrkllefkxmxpziozelwsbllaktkg
GIN: wlzsjqiaomjrmjelawsjrvqyxalgdpwqdrkeleykxfxpsioselpsbeladtkz
GIP: wlxsjoiammjpmjclausjpvqwxajgdnwqbrkclewkxdxpqioqelnsbclabtkx
GIT: wltsjkiaimjlmjylaqsjlvqsxafgdjwqxrkyleskxzxpmiomeljsbylaxtkt
GNU: wgssejivhmekmexlvpsekvlrxvegyiwlwrfxlzrksyxklijlegiswxlvwtfs
GOA: wfmsddiubmdemdrlujsdevklxuygxcwkqrerlylkrsxjfiifefcsvrluqtem
GOB: wflsdciuamddmdqluisddvkkxuxgxbwkpreqlykkrrxjeiieefbsvqluptel
GOD: wfjsdaiuymdbmdolugsdbvkixuvgxzwknreolyikrpxjciicefzsvoluntej
GOO: wfysdpiunmdqmddluvsdqvkxxukgxowkcredlyxkrexjriirefosvdluctey
GOR: wfvsdmiukmdnmdalussdnvkuxuhgxlwkzrealyukrbxjoiioeflsvaluztev
GOS: wfusdliujmdmmdzlursdmvktxuggxkwkyrezlytkraxjniinefksvzluyteu
GOT: wftsdkiuimdlmdyluqsdlvksxufgxjwkxreylyskrzxjmiimefjsvyluxtet
GOX: wfpsdgiuemdhmdulumsdhvkoxubgxfwktreulyokrvxjiiiieffsvuluttep
GOY: wfosdfiudmdgmdtlulsdgvknxuagxewksretlynkruxjhiihefesvtlusteo
GUL: wzbsxsioqmxtmxgloysxtveaxongrrwefryglsaklhxduicuezrspgloftyb
GUM: wzasxriopmxsmxfloxsxsvezxomgrqweeryflszklgxdtictezqspfloetya
GUN: wzzsxqioomxrmxelowsxrveyxolgrpwedryelsyklfxdsicsezpspelodtyz
GUT: wztsxkioimxlmxyloqsxlvesxofgrjwexryylssklzxdmicmezjspyloxtyt
GUV: wzrsxiiogmxjmxwloosxjveqxodgrhwevrywlsqklxxdkickezhspwlovtyr
GUY: wzosxfiodmxgmxtlolsxgvenxoagrewesrytlsnkluxdhichezesptlostyo
GYM: wvastrikpmtsmtflkxstsvazxkmgnqwaeruflozkhgxztiytevqslflketua
GYP: wvxstoikmmtpmtclkustpvawxkjgnnwabruclowkhdxzqiyqevnslclkbtux
HAD: vtjrrahiylrblrokigrrbuyiwivflzvynqsokmijfpwxchwcdtzrjokinssj
HAE: vtirrzhixlralrnkifrrauyhwiuflyvymqsnkmhjfowxbhwbdtyrjnkimssi
HAG: vtgrrxhivlrylrlkidrryuyfwisflwvykqslkmfjfmwxzhwzdtwrjlkikssg
HAH: vtfrrwhiulrxlrkkicrrxuyewirflvvyjqskkmejflwxyhwydtvrjkkijssf
HAJ: vtdrruhislrvlrikiarrvuycwipfltvyhqsikmcjfjwxwhwwdttrjikihssd
HAM: vtarrrhiplrslrfkixrrsuyzwimflqvyeqsfkmzjfgwxthwtdtqrjfkiessa
HAO: vtyrrphinlrqlrdkivrrquyxwikflovycqsdkmxjfewxrhwrdtorjdkicssy
HAP: vtxrrohimlrplrckiurrpuywwijflnvybqsckmwjfdwxqhwqdtnrjckibssx
HAS: vturrlhijlrmlrzkirrrmuytwigflkvyyqszkmtjfawxnhwndtkrjzkiyssu
HAT: vttrrkhiilrllrykiqrrluyswiffljvyxqsykmsjfzwxmhwmdtjrjykixsst
HAW: vtqrrhhiflrilrvkinrriuypwicflgvyuqsvkmpjfwwxjhwjdtgrjvkiussq
HAY: vtorrfhidlrglrtkilrrguynwiaflevysqstkmnjfuwxhhwhdterjtkissso
HEH: vpfrnwheulnxlnkkecrnxuuewerfhvvujqokkiejblwtyhsydpvrfkkejsof
HEM: vparnrheplnslnfkexrnsuuzwemfhqvueqofkizjbgwtthstdpqrffkeesoa
HEN: vpzrnqheolnrlnekewrnruuywelfhpvudqoekiyjbfwtshssdpprfekedsoz
HEP: vpxrnohemlnplnckeurnpuuwwejfhnvubqockiwjbdwtqhsqdpnrfckebsox
HER: vpvrnmheklnnlnakesrnnuuuwehfhlvuzqoakiujbbwtohsodplrfakezsov
HES: vpurnlhejlnmlnzkerrnmuutwegfhkvuyqozkitjbawtnhsndpkrfzkeysou
HET: vptrnkheilnllnykeqrnluusweffhjvuxqoykisjbzwtmhsmdpjrfykexsot
HEW: vpqrnhheflnilnvkenrniuupwecfhgvuuqovkipjbwwtjhsjdpgrfvkeusoq
HEX: vpprngheelnhlnukemrnhuuowebfhfvutqoukiojbvwtihsidpfrfuketsop
HEY: vpornfhedlnglntkelrnguunweafhevusqotkinjbuwthhshdperftkessoo
HIC: vlkrjbhazljcljpkahrjcuqjwawfdavqoqkpkejjxqwpdhoddlarbpkaoskk
HID: vljrjahayljbljokagrjbuqiwavfdzvqnqkokeijxpwpchocdlzrbokanskj
HIE: vlirjzhaxljaljnkafrjauqhwaufdyvqmqknkehjxowpbhobdlyrbnkamski
HIM: vlarjrhapljsljfkaxrjsuqzwamfdqvqeqkfkezjxgwpthotdlqrbfkaeska
HIN: vlzrjqhaoljrljekawrjruqywalfdpvqdqkekeyjxfwpshosdlprbekadskz
HIP: vlxrjohamljpljckaurjpuqwwajfdnvqbqkckewjxdwpqhoqdlnrbckabskx
HIS: vlurjlhajljmljzkarrjmuqtwagfdkvqyqkzketjxawpnhondlkrbzkaysku
HIT: vltrjkhailjlljykaqrjluqswaffdjvqxqkykesjxzwpmhomdljrbykaxskt
HMM: vharfrhwplfslffkwxrfsumzwwmfzqvmeqgfkazjtgwlthktdhqrxfkwesga
HOB: vflrdchualddldqkuirddukkwuxfxbvkpqeqkykjrrwjehiedfbrvqkupsel
HOD: vfjrdahuyldbldokugrdbukiwuvfxzvknqeokyijrpwjchicdfzrvokunsej
HOE: vfirdzhuxldaldnkufrdaukhwuufxyvkmqenkyhjrowjbhibdfyrvnkumsei
HOG: vfgrdxhuvldyldlkudrdyukfwusfxwvkkqelkyfjrmwjzhizdfwrvlkukseg
HON: vfzrdqhuoldrldekuwrdrukywulfxpvkdqeekyyjrfwjshisdfprvekudsez
HOP: vfxrdohumldpldckuurdpukwwujfxnvkbqeckywjrdwjqhiqdfnrvckubsex
HOT: vftrdkhuildlldykuqrdlukswuffxjvkxqeykysjrzwjmhimdfjrvykuxset
HOW: vfqrdhhufldildvkunrdiukpwucfxgvkuqevkypjrwwjjhijdfgrvvkuuseq
HOY: vfordfhudldgldtkulrdguknwuafxevksqetkynjruwjhhihdfervtkusseo
HUB: vzlrxchoalxdlxqkoirxduekwoxfrbvepqyqkskjlrwdehcedzbrpqkopsyl
HUE: vzirxzhoxlxalxnkofrxauehwoufryvemqynkshjlowdbhcbdzyrpnkomsyi
HUG: vzgrxxhovlxylxlkodrxyuefwosfrwvekqylksfjlmwdzhczdzwrplkoksyg
HUH: vzfrxwhoulxxlxkkocrxxueeworfrvvejqykksejllwdyhcydzvrpkkojsyf
HUM: vzarxrhoplxslxfkoxrxsuezwomfrqveeqyfkszjlgwdthctdzqrpfkoesya
HUN: vzzrxqhoolxrlxekowrxrueywolfrpvedqyeksyjlfwdshcsdzprpekodsyz
HUP: vzxrxohomlxplxckourxpuewwojfrnvebqyckswjldwdqhcqdznrpckobsyx
HUT: vztrxkhoilxllxykoqrxlueswoffrjvexqyykssjlzwdmhcmdzjrpykoxsyt
HYP: vvxrtohkmltpltckkurtpuawwkjfnnvabquckowjhdwzqhyqdvnrlckkbsux
ICE: uriqpzggxkpakpnjgfqpatwhvguejyuwmpqnjkhidovvbgubcryqhnjgmrqi
ICH: urfqpwggukpxkpkjgcqpxtwevgrejvuwjpqkjkeidlvvyguycrvqhkjgjrqf
ICK: urcqptggrkpukphjgzqputwbvgoejsuwgpqhjkbidivvvguvcrsqhhjggrqc
ICY: uroqpfggdkpgkptjglqpgtwnvgaejeuwspqtjkniduvvhguhcreqhtjgsrqo
IDS: uquqolgfjkomkozjfrqomtvtvfgeikuvyppzjjticavungtncqkqgzjfyrpu
IFF: uohqmygdwkmzkmmjdeqmzttgvdtegxutlpnmjhgianvsagracoxqemjdlrnh
IFS: uouqmlgdjkmmkmzjdrqmmtttvdgegkutypnzjhtiaavsngrncokqezjdyrnu
IGG: ungqlxgcvklyklljcdqlytsfvcsefwuskpmljgfizmvrzgqzcnwqdljckrmg
ILK: uicqgtgxrkgukghjxzqgutnbvxoeasungphhjbbiuivmvglvcisqyhjxgrhc
ILL: uibqgsgxqkgtkggjxyqgttnavxnearunfphgjbaiuhvmuglucirqygjxfrhb
IMP: uhxqfogwmkfpkfcjwuqfptmwvwjeznumbpgcjawitdvlqgkqchnqxcjwbrgx
INK: ugcqetgvrkeukehjvzqeutlbvvoeysulgpfhjzbisivkvgjvcgsqwhjvgrfc
INN: ugzqeqgvokerkeejvwqertlyvvleypuldpfejzyisfvksgjscgpqwejvdrfz
INS: uguqelgvjkemkezjvrqemtltvvgeykulypfzjztisavkngjncgkqwzjvyrfu
ION: ufzqdqguokdrkdejuwqdrtkyvulexpukdpeejyyirfvjsgiscfpqvejudrez
IRE: uciqazgrxkaakanjrfqaathhvrueuyuhmpbnjvhioovgbgfbccyqsnjrmrbi
IRK: uccqatgrrkaukahjrzqauthbvroeusuhgpbhjvbioivgvgfvccsqshjrgrbc
ISM: ubaqzrgqpkzskzfjqxqzstgzvqmetqugepafjuzingvftgetcbqqrfjqeraa
ITS: uauqylgpjkymkyzjprqymtftvpgeskufypzzjttimavengdncakqqzjpyrzu
IVY: uyoqwfgndkwgkwtjnlqwgtdnvnaeqeudspxtjrnikuvchgbhcyeqotjnsrxo
JAB: ttlprcfiajrdjrqiiiprdsykuixdlbtyposqimkhfruxefwebtbpjqiipqsl
JAG: ttgprxfivjryjrliidprysyfuisdlwtykoslimfhfmuxzfwzbtwpjliikqsg
JAM: ttaprrfipjrsjrfiixprssyzuimdlqtyeosfimzhfguxtfwtbtqpjfiieqsa
JAR: ttvprmfikjrnjraiisprnsyuuihdlltyzosaimuhfbuxofwobtlpjaiizqsv
JAW: ttqprhfifjrijrviinprisypuicdlgtyuosvimphfwuxjfwjbtgpjviiuqsq
JAY: ttoprffidjrgjrtiilprgsynuiadletysostimnhfuuxhfwhbtepjtiisqso
JEE: tpipnzfexjnajnniefpnasuhueudhytumooniihhboutbfsbbpypfniemqoi
JET: tptpnkfeijnljnyieqpnlsusuefdhjtuxooyiishbzutmfsmbpjpfyiexqot
JEU: tpspnjfehjnkjnxieppnksurueedhituwooxiirhbyutlfslbpipfxiewqos
JEW: tpqpnhfefjnijnvienpnisupuecdhgtuuooviiphbwutjfsjbpgpfvieuqoq
JIB: tllpjcfaajjdjjqiaipjdsqkuaxddbtqpokqiekhxrupefoeblbpbqiapqkl
JIG: tlgpjxfavjjyjjliadpjysqfuasddwtqkokliefhxmupzfozblwpbliakqkg
JIN: tlzpjqfaojjrjjeiawpjrsqyualddptqdokeieyhxfupsfosblppbeiadqkz
JOB: tflpdcfuajddjdqiuipddskkuuxdxbtkpoeqiykhrrujefiebfbpvqiupqel
JOE: tfipdzfuxjdajdniufpdaskhuuudxytkmoeniyhhroujbfibbfypvniumqei
JOG: tfgpdxfuvjdyjdliudpdyskfuusdxwtkkoeliyfhrmujzfizbfwpvliukqeg
JOT: tftpdkfuijdljdyiuqpdlsksuufdxjtkxoeyiyshrzujmfimbfjpvyiuxqet
JOW: tfqpdhfufjdijdviunpdiskpuucdxgtkuoeviyphrwujjfijbfgpvviuuqeq
JOY: tfopdffudjdgjdtiulpdgsknuuadxetksoetiynhruujhfihbfepvtiusqeo
JUG: tzgpxxfovjxyjxliodpxysefuosdrwtekoylisfhlmudzfczbzwppliokqyg
JUN: tzzpxqfoojxrjxeiowpxrseyuoldrptedoyeisyhlfudsfcsbzpppeiodqyz
JUS: tzupxlfojjxmjxziorpxmsetuogdrkteyoyzisthlaudnfcnbzkppzioyqyu
JUT: tztpxkfoijxljxyioqpxlsesuofdrjtexoyyisshlzudmfcmbzjppyioxqyt
KAB: stlorceiairdirqhiiordryktixclbsypnsqhmkgfrtxeeweatbojqhippsl
KAE: stiorzeixirairnhiforaryhtiuclysymnsnhmhgfotxbewbatyojnhimpsi
KAF: sthoryeiwirzirmhieorzrygtitclxsylnsmhmggfntxaewaatxojmhilpsh
KAS: stuorleijirmirzhirormryttigclksyynszhmtgfatxnewnatkojzhiypsu
KAT: sttorkeiiirliryhiqorlrystifcljsyxnsyhmsgfztxmewmatjojyhixpst
KAY: stoorfeidirgirthilorgryntiaclesysnsthmngfutxhewhateojthispso
KEA: spmondeebineinrhejonerulteychcsuqnorhilgbsttfesfapcofrheqpom
KEF: sphonyeewinzinmheeonzrugtetchxsulnomhiggbnttaesaapxofmhelpoh
KEG: spgonxeevinyinlhedonyrufteschwsuknolhifgbmttzeszapwoflhekpog
KEN: spzonqeeoinrinehewonrruytelchpsudnoehiygbfttsessappofehedpoz
KEP: spxonoeeminpincheuonpruwtejchnsubnochiwgbdttqesqapnofchebpox
KEX: sppongeeeinhinuhemonhruotebchfsutnouhiogbvttiesiapfofuhetpop
KEY: spoonfeedinginthelongrunteachesusnothingbuttheshapeofthespoo
KHI: smeokvebtikwikjhbbokwrrdtbqceusrinljhfdgyktqxepxamuocjhbiple
KID: sljojaeayijbijohagojbrqitavcdzsqnnkoheigxptpceocalzobohanpkj
KIF: slhojyeawijzijmhaeojzrqgtatcdxsqlnkmheggxntpaeoaalxobmhalpkh
KIN: slzojqeaoijrijehawojrrqytalcdpsqdnkeheygxftpseosalpobehadpkz
KIP: slxojoeamijpijchauojprqwtajcdnsqbnkchewgxdtpqeoqalnobchabpkx
KIR: slvojmeakijnijahasojnrqutahcdlsqznkaheugxbtpoeooallobahazpkv
KIS: sluojleajijmijzharojmrqttagcdksqynkzhetgxatpneonalkobzhaypku
KIT: sltojkeaiijlijyhaqojlrqstafcdjsqxnkyhesgxztpmeomaljobyhaxpkt
KOA: sfmoddeubideidrhujoderkltuycxcskqnerhylgrstjfeifafcovrhuqpem
KOB: sflodceuaiddidqhuioddrkktuxcxbskpneqhykgrrtjeeieafbovqhuppel
KOI: sfeodveutidwidjhubodwrkdtuqcxuskinejhydgrktjxeixafuovjhuipee
KOP: sfxodoeumidpidchuuodprkwtujcxnskbnechywgrdtjqeiqafnovchubpex
KOR: sfvodmeukidnidahusodnrkutuhcxlskzneahyugrbtjoeioaflovahuzpev
KOS: sfuodleujidmidzhurodmrkttugcxkskynezhytgratjneinafkovzhuypeu
KUE: szioxzeoxixaixnhofoxarehtoucrysemnynhshglotdbecbazyopnhompyi
KYE: sviotzekxitaitnhkfotarahtkucnysamnunhohghotzbeybavyolnhkmpui
LAB: rtlnrcdiahrdhrqgiinrdqyksixblbrypmsqgmkffrsxedweztbnjqgiposl
LAC: rtknrbdizhrchrpgihnrcqyjsiwblaryomspgmjffqsxddwdztanjpgioosk
LAD: rtjnradiyhrbhrogignrbqyisivblzrynmsogmiffpsxcdwcztznjoginosj
LAG: rtgnrxdivhryhrlgidnryqyfsisblwrykmslgmfffmsxzdwzztwnjlgikosg
LAM: rtanrrdiphrshrfgixnrsqyzsimblqryemsfgmzffgsxtdwtztqnjfgieosa
LAP: rtxnrodimhrphrcgiunrpqywsijblnrybmscgmwffdsxqdwqztnnjcgibosx
LAR: rtvnrmdikhrnhragisnrnqyusihbllryzmsagmuffbsxodwoztlnjagizosv
LAS: rtunrldijhrmhrzgirnrmqytsigblkryymszgmtffasxndwnztknjzgiyosu
LAT: rttnrkdiihrlhrygiqnrlqyssifbljryxmsygmsffzsxmdwmztjnjygixost
LAV: rtrnridighrjhrwgionrjqyqsidblhryvmswgmqffxsxkdwkzthnjwgivosr
LAW: rtqnrhdifhrihrvginnriqypsicblgryumsvgmpffwsxjdwjztgnjvgiuosq
LAX: rtpnrgdiehrhhrugimnrhqyosibblfrytmsugmoffvsxidwiztfnjugitosp
LAY: rtonrfdidhrghrtgilnrgqynsiablerysmstgmnffusxhdwhztenjtgisoso
LEA: rpmnnddebhnehnrgejnnequlseybhcruqmorgilfbsstfdsfzpcnfrgeqoom
LED: rpjnnadeyhnbhnogegnnbquisevbhzrunmoogiifbpstcdsczpznfogenooj
LEE: rpinnzdexhnahnngefnnaquhseubhyrummongihfbostbdsbzpynfngemooi
LEG: rpgnnxdevhnyhnlgednnyqufsesbhwrukmolgiffbmstzdszzpwnflgekoog
LEI: rpennvdethnwhnjgebnnwqudseqbhuruimojgidfbkstxdsxzpunfjgeiooe
LEK: rpcnntderhnuhnhgeznnuqubseobhsrugmohgibfbistvdsvzpsnfhgegooc
LET: rptnnkdeihnlhnygeqnnlqussefbhjruxmoygisfbzstmdsmzpjnfygexoot
LEU: rpsnnjdehhnkhnxgepnnkqurseebhiruwmoxgirfbystldslzpinfxgewoos
LEV: rprnnideghnjhnwgeonnjquqsedbhhruvmowgiqfbxstkdskzphnfwgevoor
LEX: rppnngdeehnhhnugemnnhquosebbhfrutmougiofbvstidsizpfnfugetoop
LEY: rponnfdedhnghntgelnngqunseabherusmotginfbusthdshzpenftgesooo
LEZ: rpnnnedechnfhnsgeknnfqumsezbhdrurmosgimfbtstgdsgzpdnfsgeroon
LIB: rllnjcdaahjdhjqgainjdqqksaxbdbrqpmkqgekfxrspedoezlbnbqgapokl
LID: rljnjadayhjbhjogagnjbqqisavbdzrqnmkogeifxpspcdoczlznboganokj
LIE: rlinjzdaxhjahjngafnjaqqhsaubdyrqmmkngehfxospbdobzlynbngamoki
LIN: rlznjqdaohjrhjegawnjrqqysalbdprqdmkegeyfxfspsdoszlpnbegadokz
LIP: rlxnjodamhjphjcgaunjpqqwsajbdnrqbmkcgewfxdspqdoqzlnnbcgabokx
LIS: rlunjldajhjmhjzgarnjmqqtsagbdkrqymkzgetfxaspndonzlknbzgayoku
LIT: rltnjkdaihjlhjygaqnjlqqssafbdjrqxmkygesfxzspmdomzljnbygaxokt
LOB: rflndcduahddhdqguinddqkksuxbxbrkpmeqgykfrrsjediezfbnvqgupoel
LOG: rfgndxduvhdyhdlgudndyqkfsusbxwrkkmelgyffrmsjzdizzfwnvlgukoeg
LOO: rfyndpdunhdqhddguvndqqkxsukbxorkcmedgyxfresjrdirzfonvdgucoey
LOP: rfxndodumhdphdcguundpqkwsujbxnrkbmecgywfrdsjqdiqzfnnvcguboex
LOT: rftndkduihdlhdyguqndlqkssufbxjrkxmeygysfrzsjmdimzfjnvyguxoet
LOW: rfqndhdufhdihdvgunndiqkpsucbxgrkumevgypfrwsjjdijzfgnvvguuoeq
LOX: rfpndgduehdhhdugumndhqkosubbxfrktmeugyofrvsjidiizffnvugutoep
LUG: rzgnxxdovhxyhxlgodnxyqefsosbrwrekmylgsfflmsdzdczzzwnplgokoyg
LUM: rzanxrdophxshxfgoxnxsqezsombrqreemyfgszflgsdtdctzzqnpfgoeoya
LUV: rzrnxidoghxjhxwgoonxjqeqsodbrhrevmywgsqflxsdkdckzzhnpwgovoyr
LUX: rzpnxgdoehxhhxugomnxhqeosobbrfretmyugsoflvsdidcizzfnpugotoyp
LYE: rvintzdkxhtahtngkfntaqahskubnyrammungohfhoszbdybzvynlngkmoui
MAC: qtkmrbcizgrcgrpfihmrcpyjriwalaqyolspfmjefqrxdcwdytamjpfionsk
MAD: qtjmraciygrbgrofigmrbpyirivalzqynlsofmiefprxccwcytzmjofinnsj
MAE: qtimrzcixgragrnfifmrapyhriualyqymlsnfmheforxbcwbytymjnfimnsi
MAG: qtgmrxcivgrygrlfidmrypyfrisalwqyklslfmfefmrxzcwzytwmjlfiknsg
MAN: qtzmrqciogrrgrefiwmrrpyyrilalpqydlsefmyeffrxscwsytpmjefidnsz
MAP: qtxmrocimgrpgrcfiumrppywrijalnqyblscfmwefdrxqcwqytnmjcfibnsx
MAR: qtvmrmcikgrngrafismrnpyurihallqyzlsafmuefbrxocwoytlmjafiznsv
MAS: qtumrlcijgrmgrzfirmrmpytrigalkqyylszfmtefarxncwnytkmjzfiynsu
MAT: qttmrkciigrlgryfiqmrlpysrifaljqyxlsyfmsefzrxmcwmytjmjyfixnst
MAW: qtqmrhcifgrigrvfinmripypricalgqyulsvfmpefwrxjcwjytgmjvfiunsq
MAX: qtpmrgciegrhgrufimmrhpyoribalfqytlsufmoefvrxicwiytfmjufitnsp
MAY: qtomrfcidgrggrtfilmrgpynriaaleqyslstfmnefurxhcwhytemjtfisnso
MED: qpjmnaceygnbgnofegmnbpuirevahzqunloofiiebprtccscypzmfofennoj
MEG: qpgmnxcevgnygnlfedmnypufresahwquklolfifebmrtzcszypwmflfeknog
MEL: qpbmnsceqgntgngfeymntpuarenahrquflogfiaebhrtucsuyprmfgfefnob
MEM: qpamnrcepgnsgnffexmnspuzremahqqueloffizebgrttcstypqmfffeenoa
MEN: qpzmnqceognrgnefewmnrpuyrelahpqudloefiyebfrtscssyppmfefednoz
MET: qptmnkceignlgnyfeqmnlpusrefahjquxloyfisebzrtmcsmypjmfyfexnot
MEW: qpqmnhcefgnignvfenmnipuprecahgquulovfipebwrtjcsjypgmfvfeunoq
MHO: qmymkpcbngkqgkdfbvmkqprxrbkaeoqrclldffxeyerqrcprymomcdfbcnly
MIB: qllmjccaagjdgjqfaimjdpqkraxadbqqplkqfekexrrpecoeylbmbqfapnkl
MIC: qlkmjbcazgjcgjpfahmjcpqjrawadaqqolkpfejexqrpdcodylambpfaonkk
MID: qljmjacaygjbgjofagmjbpqiravadzqqnlkofeiexprpccocylzmbofannkj
MIG: qlgmjxcavgjygjlfadmjypqfrasadwqqklklfefexmrpzcozylwmblfaknkg
MIL: qlbmjscaqgjtgjgfaymjtpqaranadrqqflkgfeaexhrpucouylrmbgfafnkb
MIM: qlamjrcapgjsgjffaxmjspqzramadqqqelkffezexgrptcotylqmbffaenka
MIR: qlvmjmcakgjngjafasmjnpqurahadlqqzlkafeuexbrpocooyllmbafaznkv
MIS: qlumjlcajgjmgjzfarmjmpqtragadkqqylkzfetexarpnconylkmbzfaynku
MIX: qlpmjgcaegjhgjufammjhpqorabadfqqtlkufeoexvrpicoiylfmbufatnkp
MOA: qfmmddcubgdegdrfujmdepklruyaxcqkqlerfylersrjfcifyfcmvrfuqnem
MOB: qflmdccuagddgdqfuimddpkkruxaxbqkpleqfykerrrjecieyfbmvqfupnel
MOC: qfkmdbcuzgdcgdpfuhmdcpkjruwaxaqkolepfyjerqrjdcidyfamvpfuonek
MOD: qfjmdacuygdbgdofugmdbpkiruvaxzqknleofyierprjccicyfzmvofunnej
MOG: qfgmdxcuvgdygdlfudmdypkfrusaxwqkklelfyfermrjzcizyfwmvlfukneg
MOL: qfbmdscuqgdtgdgfuymdtpkarunaxrqkflegfyaerhrjuciuyfrmvgfufneb
MOM: qfamdrcupgdsgdffuxmdspkzrumaxqqkeleffyzergrjtcityfqmvffuenea
MON: qfzmdqcuogdrgdefuwmdrpkyrulaxpqkdleefyyerfrjscisyfpmvefudnez
MOO: qfymdpcungdqgddfuvmdqpkxrukaxoqkcledfyxererjrciryfomvdfucney
MOP: qfxmdocumgdpgdcfuumdppkwrujaxnqkblecfywerdrjqciqyfnmvcfubnex
MOR: qfvmdmcukgdngdafusmdnpkuruhaxlqkzleafyuerbrjocioyflmvafuznev
MOS: qfumdlcujgdmgdzfurmdmpktrugaxkqkylezfyterarjncinyfkmvzfuyneu
MOT: qftmdkcuigdlgdyfuqmdlpksrufaxjqkxleyfyserzrjmcimyfjmvyfuxnet
MOW: qfqmdhcufgdigdvfunmdipkprucaxgqkulevfyperwrjjcijyfgmvvfuuneq
MUD: qzjmxacoygxbgxofogmxbpeirovarzqenlyofsielprdccccyzzmpofonnyj
MUG: qzgmxxcovgxygxlfodmxypefrosarwqeklylfsfelmrdzcczyzwmplfoknyg
MUM: qzamxrcopgxsgxffoxmxspezromarqqeelyffszelgrdtcctyzqmpffoenya
MUN: qzzmxqcoogxrgxefowmxrpeyrolarpqedlyefsyelfrdsccsyzpmpefodnyz
MUS: qzumxlcojgxmgxzformxmpetrogarkqeylyzfstelardnccnyzkmpzfoynyu
MUT: qztmxkcoigxlgxyfoqmxlpesrofarjqexlyyfsselzrdmccmyzjmpyfoxnyt
MYC: qvkmtbckzgtcgtpfkhmtcpajrkwanaqaolupfojehqrzdcydyvamlpfkonuk
NAB: ptllrcbiafrdfrqeiilrdoykqixzlbpypksqemkdfrqxebwextbljqeipmsl
NAE: ptilrzbixfrafrneiflraoyhqiuzlypymksnemhdfoqxbbwbxtyljneimmsi
NAG: ptglrxbivfryfrleidlryoyfqiszlwpykkslemfdfmqxzbwzxtwljleikmsg
NAH: ptflrwbiufrxfrkeiclrxoyeqirzlvpyjkskemedflqxybwyxtvljkeijmsf
NAM: ptalrrbipfrsfrfeixlrsoyzqimzlqpyeksfemzdfgqxtbwtxtqljfeiemsa
NAN: ptzlrqbiofrrfreeiwlrroyyqilzlppydkseemydffqxsbwsxtpljeeidmsz
NAP: ptxlrobimfrpfrceiulrpoywqijzlnpybkscemwdfdqxqbwqxtnljceibmsx
NAW: ptqlrhbiffrifrveinlrioypqiczlgpyuksvempdfwqxjbwjxtgljveiumsq
NAY: ptolrfbidfrgfrteillrgoynqiazlepyskstemndfuqxhbwhxteljteismso
NEB: ppllncbeafndfnqeeilndoukqexzhbpupkoqeikdbrqtebsexpblfqeepmol
NEE: ppilnzbexfnafnneeflnaouhqeuzhypumkoneihdboqtbbsbxpylfneemmoi
NEG: ppglnxbevfnyfnleedlnyoufqeszhwpukkoleifdbmqtzbszxpwlfleekmog
NET: pptlnkbeifnlfnyeeqlnlousqefzhjpuxkoyeisdbzqtmbsmxpjlfyeexmot
NEW: ppqlnhbeffnifnveenlnioupqeczhgpuukoveipdbwqtjbsjxpglfveeumoq
NIB: pllljcbaafjdfjqeailjdoqkqaxzdbpqpkkqeekdxrqpeboexlblbqeapmkl
NIL: plbljsbaqfjtfjgeayljtoqaqanzdrpqfkkgeeadxhqpubouxlrlbgeafmkb
NIM: plaljrbapfjsfjfeaxljsoqzqamzdqpqekkfeezdxgqptbotxlqlbfeaemka
NIP: plxljobamfjpfjceauljpoqwqajzdnpqbkkceewdxdqpqboqxlnlbceabmkx
NIT: pltljkbaifjlfjyeaqljloqsqafzdjpqxkkyeesdxzqpmbomxljlbyeaxmkt
NIX: plpljgbaefjhfjueamljhoqoqabzdfpqtkkueeodxvqpiboixlflbueatmkp
NOB: pflldcbuafddfdqeuilddokkquxzxbpkpkeqeykdrrqjebiexfblvqeupmel
NOD: pfjldabuyfdbfdoeugldbokiquvzxzpknkeoeyidrpqjcbicxfzlvoeunmej
NOG: pfgldxbuvfdyfdleudldyokfquszxwpkkkeleyfdrmqjzbizxfwlvleukmeg
NOH: pffldwbuufdxfdkeucldxokequrzxvpkjkekeyedrlqjybiyxfvlvkeujmef
NOM: pfaldrbupfdsfdfeuxldsokzqumzxqpkekefeyzdrgqjtbitxfqlvfeuemea
NOO: pfyldpbunfdqfddeuvldqokxqukzxopkckedeyxdreqjrbirxfolvdeucmey
NOR: pfvldmbukfdnfdaeusldnokuquhzxlpkzkeaeyudrbqjobioxfllvaeuzmev
NOS: pfuldlbujfdmfdzeurldmoktqugzxkpkykezeytdraqjnbinxfklvzeuymeu
NOT: pftldkbuifdlfdyeuqldloksqufzxjpkxkeyeysdrzqjmbimxfjlvyeuxmet
NOW: pfqldhbuffdifdveunldiokpquczxgpkukeveypdrwqjjbijxfglvveuumeq
NTH: paflywbpufyxfykepclyxofeqprzsvpfjkzketedmlqeybdyxavlqkepjmzf
NUB: pzllxcboafxdfxqeoilxdoekqoxzrbpepkyqeskdlrqdebcexzblpqeopmyl
NUN: pzzlxqboofxrfxeeowlxroeyqolzrppedkyeesydlfqdsbcsxzplpeeodmyz
NUS: pzulxlbojfxmfxzeorlxmoetqogzrkpeykyzestdlaqdnbcnxzklpzeoymyu
NUT: pztlxkboifxlfxyeoqlxloesqofzrjpexkyyessdlzqdmbcmxzjlpyeoxmyt
OAF: othkryaiwerzermdiekrznygpitylxoyljsmdmgcfnpxaawawtxkjmdillsh
OAK: otckrtaireruerhdizkrunybpioylsoygjshdmbcfipxvawvwtskjhdiglsc
OAR: otvkrmaikerneradiskrnnyupihylloyzjsadmucfbpxoawowtlkjadizlsv
OAT: ottkrkaiierlerydiqkrlnyspifyljoyxjsydmscfzpxmawmwtjkjydixlst
OBA: osmkqdahbeqeeqrdhjkqenxlphyykcoxqjrrdllcespwfavfwsckirdhqlrm
OBE: osikqzahxeqaeqndhfkqanxhphuykyoxmjrndlhceopwbavbwsykindhmlri
OBI: osekqvahteqweqjdhbkqwnxdphqykuoxijrjdldcekpwxavxwsukijdhilre
OCA: ormkpdagbepeeprdgjkpenwlpgyyjcowqjqrdklcdspvfaufwrckhrdgqlqm
ODA: oqmkodafbeoeeordfjkoenvlpfyyicovqjprdjlccspufatfwqckgrdfqlpm
ODD: oqjkoaafyeobeoodfgkobnvipfvyizovnjpodjiccppucatcwqzkgodfnlpj
ODE: oqikozafxeoaeondffkoanvhpfuyiyovmjpndjhccopubatbwqykgndfmlpi
ODS: oqukolafjeomeozdfrkomnvtpfgyikovyjpzdjtccapunatnwqkkgzdfylpu
OES: opuknlaejenmenzderknmnutpegyhkouyjozditcbaptnasnwpkkfzdeylou
OFF: oohkmyadwemzemmddekmzntgpdtygxotljnmdhgcanpsaarawoxkemddllnh
OFT: ootkmkadiemlemyddqkmlntspdfygjotxjnydhscazpsmarmwojkeyddxlnt
OHM: omakkrabpeksekfdbxkksnrzpbmyeqorejlfdfzcygpqtaptwmqkcfdbella
OHO: omykkpabnekqekddbvkkqnrxpbkyeoorcjlddfxcyepqraprwmokcddbclly
OHS: omukklabjekmekzdbrkkmnrtpbgyekoryjlzdftcyapqnapnwmkkczdbyllu
OIL: olbkjsaaqejtejgdaykjtnqapanydroqfjkgdeacxhppuaouwlrkbgdaflkb
OKA: ojmkhdaybeheehrdyjkhenolpyyybcooqjirdclcvspnfamfwjckzrdyqlim
OKE: ojikhzayxehaehndyfkhanohpyuybyoomjindchcvopnbambwjykzndymlii
OLD: oijkgaaxyegbegodxgkgbnnipxvyazonnjhodbicuppmcalcwizkyodxnlhj
OLE: oiikgzaxxegaegndxfkgannhpxuyayonmjhndbhcuopmbalbwiykyndxmlhi
OMS: ohukflawjefmefzdwrkfmnmtpwgyzkomyjgzdatctaplnaknwhkkxzdwylgu
ONE: ogikezavxeeaeendvfkeanlhpvuyyyolmjfndzhcsopkbajbwgykwndvmlfi
ONO: ogykepavneeqeeddvvkeqnlxpvkyyoolcjfddzxcsepkrajrwgokwddvclfy
ONS: ogukelavjeemeezdvrkemnltpvgyykolyjfzdztcsapknajnwgkkwzdvylfu
OOH: offkdwauuedxedkduckdxnkepuryxvokjjekdyecrlpjyaiywfvkvkdujlef
OOT: oftkdkauiedledyduqkdlnkspufyxjokxjeydyscrzpjmaimwfjkvyduxlet
OPE: oeikczatxecaecndtfkcanjhptuywyojmjdndxhcqopibahbweykundtmldi
OPS: oeukclatjecmeczdtrkcmnjtptgywkojyjdzdxtcqapinahnwekkuzdtyldu
OPT: oetkckatieclecydtqkclnjsptfywjojxjdydxscqzpimahmwejkuydtxldt
ORA: ocmkadarbeaeeardrjkaenhlpryyucohqjbrdvlcospgfaffwccksrdrqlbm
ORB: oclkacaraeadeaqdrikadnhkprxyubohpjbqdvkcorpgeafewcbksqdrplbl
ORC: ockkabarzeaceapdrhkacnhjprwyuaohojbpdvjcoqpgdafdwcakspdrolbk
ORE: ocikazarxeaaeandrfkaanhhpruyuyohmjbndvhcoopgbafbwcyksndrmlbi
ORS: ocukalarjeameazdrrkamnhtprgyukohyjbzdvtcoapgnafnwckkszdrylbu
ORT: octkakariealeaydrqkalnhsprfyujohxjbydvscozpgmafmwcjksydrxlbt
OSE: obikzzaqxezaezndqfkzanghpquytyogmjanduhcnopfbaebwbykrndqmlai
OUD: ozjkxaaoyexbexodogkxbneipovyrzoenjyodsiclppdcaccwzzkpodonlyj
OUR: ozvkxmaokexnexadoskxnneupohyrloezjyadsuclbpdoacowzlkpadozlyv
OUT: oztkxkaoiexlexydoqkxlnespofyrjoexjyydssclzpdmacmwzjkpydoxlyt
OVA: oymkwdanbeweewrdnjkwendlpnyyqcodqjxrdrlckspcfabfwyckordnqlxm
OWE: oxikvzamxevaevndmfkvanchpmuypyocmjwndqhcjopbbaabwxyknndmmlwi
OWL: oxbkvsamqevtevgdmykvtncapmnyprocfjwgdqacjhpbuaauwxrkngdmflwb
OWN: oxzkvqamoevrevedmwkvrncypmlyppocdjwedqycjfpbsaaswxpknedmdlwz
OXO: owykupalneuqeuddlvkuqnbxplkyooobcjvddpxcieparazrwwokmddlclvy
OXY: owokufaldeugeutdllkugnbnplayoeobsjvtdpnciupahazhwwekmtdlslvo
PAC: ntkjrbzizdrcdrpcihjrcmyjoiwxlanyoispcmjbfqoxdzwdvtajjpcioksk
PAD: ntjjraziydrbdrocigjrbmyioivxlznynisocmibfpoxczwcvtzjjocinksj
PAH: ntfjrwziudrxdrkcicjrxmyeoirxlvnyjiskcmebfloxyzwyvtvjjkcijksf
PAL: ntbjrsziqdrtdrgciyjrtmyaoinxlrnyfisgcmabfhoxuzwuvtrjjgcifksb
PAM: ntajrrzipdrsdrfcixjrsmyzoimxlqnyeisfcmzbfgoxtzwtvtqjjfcieksa
PAN: ntzjrqziodrrdreciwjrrmyyoilxlpnydisecmybffoxszwsvtpjjecidksz
PAP: ntxjrozimdrpdrcciujrpmywoijxlnnybisccmwbfdoxqzwqvtnjjccibksx
PAR: ntvjrmzikdrndracisjrnmyuoihxllnyzisacmubfboxozwovtljjacizksv
PAS: ntujrlzijdrmdrzcirjrmmytoigxlknyyiszcmtbfaoxnzwnvtkjjzciyksu
PAT: nttjrkziidrldryciqjrlmysoifxljnyxisycmsbfzoxmzwmvtjjjycixkst
PAW: ntqjrhzifdridrvcinjrimypoicxlgnyuisvcmpbfwoxjzwjvtgjjvciuksq
PAX: ntpjrgziedrhdrucimjrhmyooibxlfnytisucmobfvoxizwivtfjjucitksp
PAY: ntojrfziddrgdrtciljrgmynoiaxlenysistcmnbfuoxhzwhvtejjtciskso
PEA: npmjndzebdnednrcejjnemuloeyxhcnuqiorcilbbsotfzsfvpcjfrceqkom
PEC: npkjnbzezdncdnpcehjncmujoewxhanuoiopcijbbqotdzsdvpajfpceokok
PED: npjjnazeydnbdnocegjnbmuioevxhznunioociibbpotczscvpzjfocenkoj
PEE: npijnzzexdnadnncefjnamuhoeuxhynumioncihbbootbzsbvpyjfncemkoi
PEG: npgjnxzevdnydnlcedjnymufoesxhwnukiolcifbbmotzzszvpwjflcekkog
PEH: npfjnwzeudnxdnkcecjnxmueoerxhvnujiokciebblotyzsyvpvjfkcejkof
PEN: npzjnqzeodnrdnecewjnrmuyoelxhpnudioeciybbfotszssvppjfecedkoz
PEP: npxjnozemdnpdncceujnpmuwoejxhnnubiocciwbbdotqzsqvpnjfccebkox
PER: npvjnmzekdnndnacesjnnmuuoehxhlnuzioaciubbbotozsovpljfacezkov
PES: npujnlzejdnmdnzcerjnmmutoegxhknuyiozcitbbaotnzsnvpkjfzceykou
PET: nptjnkzeidnldnyceqjnlmusoefxhjnuxioycisbbzotmzsmvpjjfycexkot
PEW: npqjnhzefdnidnvcenjnimupoecxhgnuuiovcipbbwotjzsjvpgjfvceukoq
PHI: nmejkvzbtdkwdkjcbbjkwmrdobqxeunriiljcfdbykoqxzpxvmujcjcbikle
PHT: nmtjkkzbidkldkycbqjklmrsobfxejnrxilycfsbyzoqmzpmvmjjcycbxklt
PIA: nlmjjdzabdjedjrcajjjemqloayxdcnqqikrcelbxsopfzofvlcjbrcaqkkm
PIC: nlkjjbzazdjcdjpcahjjcmqjoawxdanqoikpcejbxqopdzodvlajbpcaokkk
PIE: nlijjzzaxdjadjncafjjamqhoauxdynqmikncehbxoopbzobvlyjbncamkki
PIG: nlgjjxzavdjydjlcadjjymqfoasxdwnqkiklcefbxmopzzozvlwjblcakkkg
PIN: nlzjjqzaodjrdjecawjjrmqyoalxdpnqdikeceybxfopszosvlpjbecadkkz
PIP: nlxjjozamdjpdjccaujjpmqwoajxdnnqbikccewbxdopqzoqvlnjbccabkkx
PIS: nlujjlzajdjmdjzcarjjmmqtoagxdknqyikzcetbxaopnzonvlkjbzcaykku
PIT: nltjjkzaidjldjycaqjjlmqsoafxdjnqxikycesbxzopmzomvljjbycaxkkt
PIU: nlsjjjzahdjkdjxcapjjkmqroaexdinqwikxcerbxyoplzolvlijbxcawkks
PIX: nlpjjgzaedjhdjucamjjhmqooabxdfnqtikuceobxvopizoivlfjbucatkkp
PLY: niojgfzxddggdgtcxljggmnnoxaxaennsihtcbnbuuomhzlhviejytcxskho
POD: nfjjdazuyddbddocugjdbmkiouvxxznknieocyibrpojczicvfzjvocunkej
POH: nffjdwzuuddxddkcucjdxmkeourxxvnkjiekcyebrlojyziyvfvjvkcujkef
POI: nfejdvzutddwddjcubjdwmkdouqxxunkiiejcydbrkojxzixvfujvjcuikee
POL: nfbjdszuqddtddgcuyjdtmkaounxxrnkfiegcyabrhojuziuvfrjvgcufkeb
POM: nfajdrzupddsddfcuxjdsmkzoumxxqnkeiefcyzbrgojtzitvfqjvfcuekea
POP: nfxjdozumddpddccuujdpmkwoujxxnnkbieccywbrdojqziqvfnjvccubkex
POT: nftjdkzuiddlddycuqjdlmksoufxxjnkxieycysbrzojmzimvfjjvycuxket
POW: nfqjdhzufddiddvcunjdimkpoucxxgnkuievcypbrwojjzijvfgjvvcuukeq
POX: nfpjdgzueddhdducumjdhmkooubxxfnktieucyobrvojiziivffjvucutkep
PRO: ncyjapzrndaqdadcrvjaqmhxorkxuonhcibdcvxboeogrzfrvcojsdcrckby
PRY: ncojafzrddagdatcrljagmhnoraxuenhsibtcvnbouoghzfhvcejstcrskbo
PSI: nbejzvzqtdzwdzjcqbjzwmgdoqqxtungiiajcudbnkofxzexvbujrjcqikae
PST: nbtjzkzqidzldzycqqjzlmgsoqfxtjngxiaycusbnzofmzemvbjjrycqxkat
PUB: nzljxczoadxddxqcoijxdmekooxxrbnepiyqcskblrodezcevzbjpqcopkyl
PUD: nzjjxazoydxbdxocogjxbmeioovxrzneniyocsiblpodczccvzzjpoconkyj
PUG: nzgjxxzovdxydxlcodjxymefoosxrwnekiylcsfblmodzzczvzwjplcokkyg
PUL: nzbjxszoqdxtdxgcoyjxtmeaoonxrrnefiygcsablhoduzcuvzrjpgcofkyb
PUN: nzzjxqzoodxrdxecowjxrmeyoolxrpnediyecsyblfodszcsvzpjpecodkyz
PUP: nzxjxozomdxpdxccoujxpmewoojxrnnebiyccswbldodqzcqvznjpccobkyx
PUR: nzvjxmzokdxndxacosjxnmeuoohxrlneziyacsublbodozcovzljpacozkyv
PUS: nzujxlzojdxmdxzcorjxmmetoogxrkneyiyzcstblaodnzcnvzkjpzcoykyu
PUT: nztjxkzoidxldxycoqjxlmesoofxrjnexiyycssblzodmzcmvzjjpycoxkyt
PYA: nvmjtdzkbdtedtrckjjtemalokyxncnaqiurcolbhsozfzyfvvcjlrckqkum
PYE: nvijtzzkxdtadtnckfjtamahokuxnynamiuncohbhoozbzybvvyjlnckmkui
PYX: nvpjtgzkedthdtuckmjthmaookbxnfnatiuucoobhvozizyivvfjlucktkup
QAT: mttirkyiicrlcrybiqirllysnifwljmyxhsybmsafznxmywmutjijybixjst
QIS: mluijlyajcjmcjzbarijmlqtnagwdkmqyhkzbetaxanpnyonulkibzbayjku
QUA: mzmixdyobcxecxrbojixelelnoywrcmeqhyrbslalsndfycfuzciprboqjym
RAD: ltjhraxiybrbbroaighrbkyimivvlzlyngsoamizfpmxcxwcttzhjoainisj
RAG: ltghrxxivbrybrlaidhrykyfmisvlwlykgslamfzfmmxzxwzttwhjlaikisg
RAH: ltfhrwxiubrxbrkaichrxkyemirvlvlyjgskamezflmxyxwyttvhjkaijisf
RAI: ltehrvxitbrwbrjaibhrwkydmiqvlulyigsjamdzfkmxxxwxttuhjjaiiise
RAJ: ltdhruxisbrvbriaiahrvkycmipvltlyhgsiamczfjmxwxwwttthjiaihisd
RAM: ltahrrxipbrsbrfaixhrskyzmimvlqlyegsfamzzfgmxtxwtttqhjfaieisa
RAN: ltzhrqxiobrrbreaiwhrrkyymilvlplydgseamyzffmxsxwsttphjeaidisz
RAP: ltxhroximbrpbrcaiuhrpkywmijvlnlybgscamwzfdmxqxwqttnhjcaibisx
RAS: ltuhrlxijbrmbrzairhrmkytmigvlklyygszamtzfamxnxwnttkhjzaiyisu
RAT: ltthrkxiibrlbryaiqhrlkysmifvljlyxgsyamszfzmxmxwmttjhjyaixist
RAW: ltqhrhxifbribrvainhrikypmicvlglyugsvampzfwmxjxwjttghjvaiuisq
RAX: ltphrgxiebrhbruaimhrhkyomibvlflytgsuamozfvmxixwittfhjuaitisp
RAY: ltohrfxidbrgbrtailhrgkynmiavlelysgstamnzfumxhxwhttehjtaisiso
REB: lplhncxeabndbnqaeihndkukmexvhblupgoqaikzbrmtexsetpbhfqaepiol
REC: lpkhnbxezbncbnpaehhnckujmewvhaluogopaijzbqmtdxsdtpahfpaeoiok
RED: lpjhnaxeybnbbnoaeghnbkuimevvhzlungooaiizbpmtcxsctpzhfoaenioj
REE: lpihnzxexbnabnnaefhnakuhmeuvhylumgonaihzbomtbxsbtpyhfnaemioi
REF: lphhnyxewbnzbnmaeehnzkugmetvhxlulgomaigzbnmtaxsatpxhfmaelioh
REG: lpghnxxevbnybnlaedhnykufmesvhwlukgolaifzbmmtzxsztpwhflaekiog
REI: lpehnvxetbnwbnjaebhnwkudmeqvhuluigojaidzbkmtxxsxtpuhfjaeiioe
REM: lpahnrxepbnsbnfaexhnskuzmemvhqluegofaizzbgmttxsttpqhffaeeioa
REP: lpxhnoxembnpbncaeuhnpkuwmejvhnlubgocaiwzbdmtqxsqtpnhfcaebiox
RES: lpuhnlxejbnmbnzaerhnmkutmegvhkluygozaitzbamtnxsntpkhfzaeyiou
RET: lpthnkxeibnlbnyaeqhnlkusmefvhjluxgoyaiszbzmtmxsmtpjhfyaexiot
REV: lprhnixegbnjbnwaeohnjkuqmedvhhluvgowaiqzbxmtkxsktphhfwaevior
REX: lpphngxeebnhbnuaemhnhkuomebvhflutgouaiozbvmtixsitpfhfuaetiop
RHO: lmyhkpxbnbkqbkdabvhkqkrxmbkveolrcgldafxzyemqrxprtmohcdabcily
RIA: llmhjdxabbjebjraajhjekqlmayvdclqqgkraelzxsmpfxoftlchbraaqikm
RIB: lllhjcxaabjdbjqaaihjdkqkmaxvdblqpgkqaekzxrmpexoetlbhbqaapikl
RID: lljhjaxaybjbbjoaaghjbkqimavvdzlqngkoaeizxpmpcxoctlzhboaanikj
RIF: llhhjyxawbjzbjmaaehjzkqgmatvdxlqlgkmaegzxnmpaxoatlxhbmaalikh
RIG: llghjxxavbjybjlaadhjykqfmasvdwlqkgklaefzxmmpzxoztlwhblaakikg
RIM: llahjrxapbjsbjfaaxhjskqzmamvdqlqegkfaezzxgmptxottlqhbfaaeika
RIN: llzhjqxaobjrbjeaawhjrkqymalvdplqdgkeaeyzxfmpsxostlphbeaadikz
RIP: llxhjoxambjpbjcaauhjpkqwmajvdnlqbgkcaewzxdmpqxoqtlnhbcaabikx
ROB: lflhdcxuabddbdqauihddkkkmuxvxblkpgeqaykzrrmjexietfbhvqaupiel
ROC: lfkhdbxuzbdcbdpauhhdckkjmuwvxalkogepayjzrqmjdxidtfahvpauoiek
ROD: lfjhdaxuybdbbdoaughdbkkimuvvxzlkngeoayizrpmjcxictfzhvoauniej
ROE: lfihdzxuxbdabdnaufhdakkhmuuvxylkmgenayhzromjbxibtfyhvnaumiei
ROM: lfahdrxupbdsbdfauxhdskkzmumvxqlkegefayzzrgmjtxittfqhvfaueiea
ROT: lfthdkxuibdlbdyauqhdlkksmufvxjlkxgeyayszrzmjmximtfjhvyauxiet
ROW: lfqhdhxufbdibdvaunhdikkpmucvxglkugevaypzrwmjjxijtfghvvauuieq
RUB: lzlhxcxoabxdbxqaoihxdkekmoxvrblepgyqaskzlrmdexcetzbhpqaopiyl
RUE: lzihxzxoxbxabxnaofhxakehmouvrylemgynashzlomdbxcbtzyhpnaomiyi
RUG: lzghxxxovbxybxlaodhxykefmosvrwlekgylasfzlmmdzxcztzwhplaokiyg
RUM: lzahxrxopbxsbxfaoxhxskezmomvrqleegyfaszzlgmdtxcttzqhpfaoeiya
RUN: lzzhxqxoobxrbxeaowhxrkeymolvrpledgyeasyzlfmdsxcstzphpeaodiyz
RUT: lzthxkxoibxlbxyaoqhxlkesmofvrjlexgyyasszlzmdmxcmtzjhpyaoxiyt
RYA: lvmhtdxkbbtebtrakjhtekalmkyvnclaqguraolzhsmzfxyftvchlrakqium
RYE: lvihtzxkxbtabtnakfhtakahmkuvnylamgunaohzhomzbxybtvyhlnakmiui
SAB: ktlgrcwiaardarqziigrdjyklixulbkypfsqzmkyfrlxewwestbgjqziphsl
SAC: ktkgrbwizarcarpzihgrcjyjliwulakyofspzmjyfqlxdwwdstagjpziohsk
SAD: ktjgrawiyarbaroziggrbjyilivulzkynfsozmiyfplxcwwcstzgjozinhsj
SAE: ktigrzwixaraarnzifgrajyhliuulykymfsnzmhyfolxbwwbstygjnzimhsi
SAG: ktggrxwivaryarlzidgryjyflisulwkykfslzmfyfmlxzwwzstwgjlzikhsg
SAL: ktbgrswiqartargziygrtjyalinulrkyffsgzmayfhlxuwwustrgjgzifhsb
SAP: ktxgrowimarparcziugrpjywlijulnkybfsczmwyfdlxqwwqstngjczibhsx
SAT: kttgrkwiiarlaryziqgrljyslifuljkyxfsyzmsyfzlxmwwmstjgjyzixhst
SAU: ktsgrjwiharkarxzipgrkjyrlieulikywfsxzmryfylxlwwlstigjxziwhss
SAW: ktqgrhwifariarvzingrijypliculgkyufsvzmpyfwlxjwwjstggjvziuhsq
SAX: ktpgrgwiearharuzimgrhjyolibulfkytfsuzmoyfvlxiwwistfgjuzithsp
SAY: ktogrfwidargartzilgrgjynliaulekysfstzmnyfulxhwwhstegjtzishso
SEA: kpmgndwebaneanrzejgnejulleyuhckuqforzilybsltfwsfspcgfrzeqhom
SEC: kpkgnbwezancanpzehgncjujlewuhakuofopzijybqltdwsdspagfpzeohok
SEE: kpignzwexanaannzefgnajuhleuuhykumfonzihyboltbwsbspygfnzemhoi
SEG: kpggnxwevanyanlzedgnyjuflesuhwkukfolzifybmltzwszspwgflzekhog
SEI: kpegnvwetanwanjzebgnwjudlequhukuifojzidybkltxwsxspugfjzeihoe
SEL: kpbgnsweqantangzeygntjualenuhrkuffogziaybhltuwsusprgfgzefhob
SEN: kpzgnqweoanranezewgnrjuyleluhpkudfoeziyybfltswsssppgfezedhoz
SER: kpvgnmwekannanazesgnnjuulehuhlkuzfoaziuybbltowsosplgfazezhov
SET: kptgnkweianlanyzeqgnljuslefuhjkuxfoyzisybzltmwsmspjgfyzexhot
SEW: kpqgnhwefanianvzengnijuplecuhgkuufovzipybwltjwsjspggfvzeuhoq
SEX: kppgngweeanhanuzemgnhjuolebuhfkutfouzioybvltiwsispfgfuzethop
SHA: kmmgkdwbbakeakrzbjgkejrllbyueckrqflrzflyyslqfwpfsmcgcrzbqhlm
SHE: kmigkzwbxakaaknzbfgkajrhlbuueykrmflnzfhyyolqbwpbsmygcnzbmhli
SHH: kmfgkwwbuakxakkzbcgkxjrelbruevkrjflkzfeyyllqywpysmvgckzbjhlf
SHY: kmogkfwbdakgaktzblgkgjrnlbaueekrsfltzfnyyulqhwphsmegctzbshlo
SIB: kllgjcwaaajdajqzaigjdjqklaxudbkqpfkqzekyxrlpewoeslbgbqzaphkl
SIC: klkgjbwazajcajpzahgjcjqjlawudakqofkpzejyxqlpdwodslagbpzaohkk
SIM: klagjrwapajsajfzaxgjsjqzlamudqkqefkfzezyxglptwotslqgbfzaehka
SIN: klzgjqwaoajrajezawgjrjqylaludpkqdfkezeyyxflpswosslpgbezadhkz
SIP: klxgjowamajpajczaugjpjqwlajudnkqbfkczewyxdlpqwoqslngbczabhkx
SIR: klvgjmwakajnajazasgjnjqulahudlkqzfkazeuyxblpowoosllgbazazhkv
SIS: klugjlwajajmajzzargjmjqtlagudkkqyfkzzetyxalpnwonslkgbzzayhku
SIT: kltgjkwaiajlajyzaqgjljqslafudjkqxfkyzesyxzlpmwomsljgbyzaxhkt
SIX: klpgjgwaeajhajuzamgjhjqolabudfkqtfkuzeoyxvlpiwoislfgbuzathkp
SKA: kjmghdwybaheahrzyjghejollyyubckoqfirzclyvslnfwmfsjcgzrzyqhim
SKI: kjeghvwytahwahjzybghwjodlyqubukoifijzcdyvklnxwmxsjugzjzyihie
SKY: kjoghfwydahgahtzylghgjonlyaubekosfitzcnyvulnhwmhsjegztzyshio
SLY: kioggfwxdaggagtzxlgggjnnlxauaeknsfhtzbnyuulmhwlhsiegytzxshho
SOB: kflgdcwuaaddadqzuigddjkkluxuxbkkpfeqzykyrrljewiesfbgvqzuphel
SOD: kfjgdawuyadbadozuggdbjkiluvuxzkknfeozyiyrpljcwicsfzgvozunhej
SOL: kfbgdswuqadtadgzuygdtjkalunuxrkkffegzyayrhljuwiusfrgvgzufheb
SOM: kfagdrwupadsadfzuxgdsjkzlumuxqkkefefzyzyrgljtwitsfqgvfzuehea
SON: kfzgdqwuoadradezuwgdrjkyluluxpkkdfeezyyyrfljswissfpgvezudhez
SOP: kfxgdowumadpadczuugdpjkwlujuxnkkbfeczywyrdljqwiqsfngvczubhex
SOS: kfugdlwujadmadzzurgdmjktluguxkkkyfezzytyraljnwinsfkgvzzuyheu
SOT: kftgdkwuiadladyzuqgdljkslufuxjkkxfeyzysyrzljmwimsfjgvyzuxhet
SOU: kfsgdjwuhadkadxzupgdkjkrlueuxikkwfexzyryryljlwilsfigvxzuwhes
SOW: kfqgdhwufadiadvzungdijkplucuxgkkufevzypyrwljjwijsfggvvzuuheq
SOX: kfpgdgwueadhaduzumgdhjkolubuxfkktfeuzyoyrvljiwiisffgvuzuthep
SOY: kfogdfwudadgadtzulgdgjknluauxekksfetzynyruljhwihsfegvtzusheo
SPA: kemgcdwtbaceacrztjgcejjlltyuwckjqfdrzxlyqslifwhfsecgurztqhdm
SPY: keogcfwtdacgactztlgcgjjnltauwekjsfdtzxnyqulihwhhseegutztshdo
SRI: kcegavwrtaawaajzrbgawjhdlrquuukhifbjzvdyoklgxwfxscugsjzrihbe
STY: kaogyfwpdaygaytzplgygjfnlpausekfsfztztnymulehwdhsaegqtzpshzo
SUB: kzlgxcwoaaxdaxqzoigxdjekloxurbkepfyqzskylrldewceszbgpqzophyl
SUE: kzigxzwoxaxaaxnzofgxajehlouurykemfynzshyloldbwcbszygpnzomhyi
SUK: kzcgxtworaxuaxhzozgxujebloourskegfyhzsbylildvwcvszsgphzoghyc
SUM: kzagxrwopaxsaxfzoxgxsjezlomurqkeefyfzszylgldtwctszqgpfzoehya
SUN: kzzgxqwooaxraxezowgxrjeylolurpkedfyezsyylfldswcsszpgpezodhyz
SUP: kzxgxowomaxpaxczougxpjewlojurnkebfyczswyldldqwcqszngpczobhyx
SUQ: kzwgxnwolaxoaxbzotgxojevloiurmkeafybzsvylcldpwcpszmgpbzoahyw
SYN: kvzgtqwkoatratezkwgtrjaylklunpkadfuezoyyhflzswyssvpglezkdhuz
TAB: jtlfrcviazrdzrqyiifrdiykkixtlbjypesqymkxfrkxevwertbfjqyipgsl
TAD: jtjfraviyzrbzroyigfrbiyikivtlzjynesoymixfpkxcvwcrtzfjoyingsj
TAE: jtifrzvixzrazrnyiffraiyhkiutlyjymesnymhxfokxbvwbrtyfjnyimgsi
TAG: jtgfrxvivzryzrlyidfryiyfkistlwjykeslymfxfmkxzvwzrtwfjlyikgsg
TAJ: jtdfruviszrvzriyiafrviyckiptltjyhesiymcxfjkxwvwwrttfjiyihgsd
TAM: jtafrrvipzrszrfyixfrsiyzkimtlqjyeesfymzxfgkxtvwtrtqfjfyiegsa
TAN: jtzfrqviozrrzreyiwfrriyykiltlpjydeseymyxffkxsvwsrtpfjeyidgsz
TAO: jtyfrpvinzrqzrdyivfrqiyxkiktlojycesdymxxfekxrvwrrtofjdyicgsy
TAP: jtxfrovimzrpzrcyiufrpiywkijtlnjybescymwxfdkxqvwqrtnfjcyibgsx
TAR: jtvfrmvikzrnzrayisfrniyukihtlljyzesaymuxfbkxovwortlfjayizgsv
TAS: jtufrlvijzrmzrzyirfrmiytkigtlkjyyeszymtxfakxnvwnrtkfjzyiygsu
TAT: jttfrkviizrlzryyiqfrliyskiftljjyxesyymsxfzkxmvwmrtjfjyyixgst
TAU: jtsfrjvihzrkzrxyipfrkiyrkietlijywesxymrxfykxlvwlrtifjxyiwgss
TAV: jtrfrivigzrjzrwyiofrjiyqkidtlhjyveswymqxfxkxkvwkrthfjwyivgsr
TAW: jtqfrhvifzrizrvyinfriiypkictlgjyuesvympxfwkxjvwjrtgfjvyiugsq
TAX: jtpfrgviezrhzruyimfrhiyokibtlfjytesuymoxfvkxivwirtffjuyitgsp
TEA: jpmfndvebzneznryejfneiulkeythcjuqeoryilxbsktfvsfrpcffryeqgom
TED: jpjfnaveyznbznoyegfnbiuikevthzjuneooyiixbpktcvscrpzffoyengoj
TEE: jpifnzvexznaznnyeffnaiuhkeuthyjumeonyihxboktbvsbrpyffnyemgoi
TEG: jpgfnxvevznyznlyedfnyiufkesthwjukeolyifxbmktzvszrpwfflyekgog
TEL: jpbfnsveqzntzngyeyfntiuakenthrjufeogyiaxbhktuvsurprffgyefgob
TEN: jpzfnqveoznrzneyewfnriuykelthpjudeoeyiyxbfktsvssrppffeyedgoz
TET: jptfnkveiznlznyyeqfnliuskefthjjuxeoyyisxbzktmvsmrpjffyyexgot
TEW: jpqfnhvefzniznvyenfniiupkecthgjuueovyipxbwktjvsjrpgffvyeugoq
THE: jmifkzvbxzkazknybffkairhkbuteyjrmelnyfhxyokqbvpbrmyfcnybmgli
THO: jmyfkpvbnzkqzkdybvfkqirxkbkteojrceldyfxxyekqrvprrmofcdybcgly
THY: jmofkfvbdzkgzktyblfkgirnkbateejrseltyfnxyukqhvphrmefctybsglo
TIC: jlkfjbvazzjczjpyahfjciqjkawtdajqoekpyejxxqkpdvodrlafbpyaogkk
TIE: jlifjzvaxzjazjnyaffjaiqhkautdyjqmeknyehxxokpbvobrlyfbnyamgki
TIL: jlbfjsvaqzjtzjgyayfjtiqakantdrjqfekgyeaxxhkpuvourlrfbgyafgkb
TIN: jlzfjqvaozjrzjeyawfjriqykaltdpjqdekeyeyxxfkpsvosrlpfbeyadgkz
TIP: jlxfjovamzjpzjcyaufjpiqwkajtdnjqbekcyewxxdkpqvoqrlnfbcyabgkx
TIS: jlufjlvajzjmzjzyarfjmiqtkagtdkjqyekzyetxxakpnvonrlkfbzyaygku
TIT: jltfjkvaizjlzjyyaqfjliqskaftdjjqxekyyesxxzkpmvomrljfbyyaxgkt
TOD: jfjfdavuyzdbzdoyugfdbikikuvtxzjkneeoyyixrpkjcvicrfzfvoyungej
TOE: jfifdzvuxzdazdnyuffdaikhkuutxyjkmeenyyhxrokjbvibrfyfvnyumgei
TOG: jfgfdxvuvzdyzdlyudfdyikfkustxwjkkeelyyfxrmkjzvizrfwfvlyukgeg
TOM: jfafdrvupzdszdfyuxfdsikzkumtxqjkeeefyyzxrgkjtvitrfqfvfyuegea
TON: jfzfdqvuozdrzdeyuwfdrikykultxpjkdeeeyyyxrfkjsvisrfpfveyudgez
TOO: jfyfdpvunzdqzddyuvfdqikxkuktxojkceedyyxxrekjrvirrfofvdyucgey
TOP: jfxfdovumzdpzdcyuufdpikwkujtxnjkbeecyywxrdkjqviqrfnfvcyubgex
TOR: jfvfdmvukzdnzdayusfdnikukuhtxljkzeeayyuxrbkjoviorflfvayuzgev
TOT: jftfdkvuizdlzdyyuqfdlikskuftxjjkxeeyyysxrzkjmvimrfjfvyyuxget
TOW: jfqfdhvufzdizdvyunfdiikpkuctxgjkueevyypxrwkjjvijrfgfvvyuugeq
TOY: jfofdfvudzdgzdtyulfdgiknkuatxejkseetyynxrukjhvihrfefvtyusgeo
TRY: jcofafvrdzagzatyrlfagihnkratuejhsebtyvnxoukghvfhrcefstyrsgbo
TSK: jbcfztvqrzzuzzhyqzfzuigbkqottsjggeahyubxnikfvvevrbsfrhyqggac
TUB: jzlfxcvoazxdzxqyoifxdiekkoxtrbjepeyqyskxlrkdevcerzbfpqyopgyl
TUG: jzgfxxvovzxyzxlyodfxyiefkostrwjekeylysfxlmkdzvczrzwfplyokgyg
TUI: jzefxvvotzxwzxjyobfxwiedkoqtrujeieyjysdxlkkdxvcxrzufpjyoigye
TUN: jzzfxqvoozxrzxeyowfxrieykoltrpjedeyeysyxlfkdsvcsrzpfpeyodgyz
TUP: jzxfxovomzxpzxcyoufxpiewkojtrnjebeycyswxldkdqvcqrznfpcyobgyx
TUT: jztfxkvoizxlzxyyoqfxlieskoftrjjexeyyyssxlzkdmvcmrzjfpyyoxgyt
TUX: jzpfxgvoezxhzxuyomfxhieokobtrfjeteyuysoxlvkdivcirzffpuyotgyp
TWA: jxmfvdvmbzvezvrymjfveiclkmytpcjcqewryqlxjskbfvafrxcfnrymqgwm
TWO: jxyfvpvmnzvqzvdymvfvqicxkmktpojccewdyqxxjekbrvarrxofndymcgwy
TYE: jviftzvkxztaztnykfftaiahkkutnyjameunyohxhokzbvybrvyflnykmgui
UDO: iqyeopufnyoqyodxfveoqhvxjfksioivcdpdxjxwcejurutrqqoegdxfcfpy
UGH: infelwucuylxylkxccelxhsejcrsfvisjdmkxgewzljryuqyqnvedkxcjfmf
UKE: ijiehzuyxyhayhnxyfehahohjyusbyiomdinxchwvojnbumbqjyeznxymfii
ULU: iisegjuxhygkygxxxpegkhnrjxesaiinwdhxxbrwuyjmlullqiieyxxxwfhs
UMM: ihaefruwpyfsyffxwxefshmzjwmszqimedgfxazwtgjltuktqhqexfxwefga
UMP: ihxefouwmyfpyfcxwuefphmwjwjsznimbdgcxawwtdjlqukqqhnexcxwbfgx
UNS: igueeluvjyemyezxvreemhltjvgsykilydfzxztwsajknujnqgkewzxvyffu
UPO: ieyecputnycqycdxtvecqhjxjtkswoijcdddxxxwqejiruhrqeoeudxtcfdy
UPS: ieueclutjycmyczxtrecmhjtjtgswkijyddzxxtwqajinuhnqekeuzxtyfdu
URB: icleacurayadyaqxrieadhhkjrxsubihpdbqxvkworjgeufeqcbesqxrpfbl
URD: icjeaauryyabyaoxrgeabhhijrvsuzihndboxviwopjgcufcqczesoxrnfbj
URN: iczeaquroyaryaexrwearhhyjrlsupihddbexvywofjgsufsqcpesexrdfbz
URP: icxeaourmyapyacxrueaphhwjrjsunihbdbcxvwwodjgqufqqcnescxrbfbx
USE: ibiezzuqxyzayznxqfezahghjqustyigmdanxuhwnojfbuebqbyernxqmfai
UTA: iameydupbyyeyyrxpjeyehfljpysscifqdzrxtlwmsjefudfqaceqrxpqfzm
UTE: iaieyzupxyyayynxpfeyahfhjpussyifmdznxthwmojebudbqayeqnxpmfzi
UTS: iaueylupjyymyyzxpreymhftjpgsskifydzzxttwmajenudnqakeqzxpyfzu
VAC: htkdrbtizxrcxrpwihdrcgyjiiwrlahyocspwmjvfqixdtwdptadjpwioesk
VAN: htzdrqtioxrrxrewiwdrrgyyiilrlphydcsewmyvffixstwsptpdjewidesz
VAR: htvdrmtikxrnxrawisdrngyuiihrllhyzcsawmuvfbixotwoptldjawizesv
VAS: htudrltijxrmxrzwirdrmgytiigrlkhyycszwmtvfaixntwnptkdjzwiyesu
VAT: httdrktiixrlxrywiqdrlgysiifrljhyxcsywmsvfzixmtwmptjdjywixest
VAU: htsdrjtihxrkxrxwipdrkgyriierlihywcsxwmrvfyixltwlptidjxwiwess
VAV: htrdritigxrjxrwwiodrjgyqiidrlhhyvcswwmqvfxixktwkpthdjwwivesr
VAW: htqdrhtifxrixrvwindrigypiicrlghyucsvwmpvfwixjtwjptgdjvwiuesq
VEE: hpidnztexxnaxnnwefdnaguhieurhyhumconwihvboitbtsbppydfnwemeoi
VEG: hpgdnxtevxnyxnlweddnygufiesrhwhukcolwifvbmitztszppwdflwekeog
VET: hptdnkteixnlxnyweqdnlgusiefrhjhuxcoywisvbzitmtsmppjdfywexeot
VEX: hppdngteexnhxnuwemdnhguoiebrhfhutcouwiovbvititsippfdfuweteop
VIA: hlmdjdtabxjexjrwajdjegqliayrdchqqckrwelvxsipftofplcdbrwaqekm
VID: hljdjatayxjbxjowagdjbgqiiavrdzhqnckoweivxpipctocplzdbowanekj
VIE: hlidjztaxxjaxjnwafdjagqhiaurdyhqmcknwehvxoipbtobplydbnwameki
VIG: hlgdjxtavxjyxjlwaddjygqfiasrdwhqkcklwefvxmipztozplwdblwakekg
VIM: hladjrtapxjsxjfwaxdjsgqziamrdqhqeckfwezvxgipttotplqdbfwaeeka
VIS: hludjltajxjmxjzwardjmgqtiagrdkhqyckzwetvxaipntonplkdbzwayeku
VOE: hfiddztuxxdaxdnwufddagkhiuurxyhkmcenwyhvroijbtibpfydvnwumeei
VOW: hfqddhtufxdixdvwunddigkpiucrxghkucevwypvrwijjtijpfgdvvwuueeq
VOX: hfpddgtuexdhxduwumddhgkoiubrxfhktceuwyovrvijitiipffdvuwuteep
VUG: hzgdxxtovxxyxxlwoddxygefiosrrwhekcylwsfvlmidztczpzwdplwokeyg
VUM: hzadxrtopxxsxxfwoxdxsgeziomrrqheecyfwszvlgidttctpzqdpfwoeeya
WAB: gtlcrcsiawrdwrqviicrdfykhixqlbgypbsqvmkufrhxesweotbcjqvipdsl
WAD: gtjcrasiywrbwrovigcrbfyihivqlzgynbsovmiufphxcswcotzcjovindsj
WAE: gticrzsixwrawrnvifcrafyhhiuqlygymbsnvmhufohxbswbotycjnvimdsi
WAG: gtgcrxsivwrywrlvidcryfyfhisqlwgykbslvmfufmhxzswzotwcjlvikdsg
WAN: gtzcrqsiowrrwreviwcrrfyyhilqlpgydbsevmyuffhxsswsotpcjeviddsz
WAP: gtxcrosimwrpwrcviucrpfywhijqlngybbscvmwufdhxqswqotncjcvibdsx
WAR: gtvcrmsikwrnwraviscrnfyuhihqllgyzbsavmuufbhxoswootlcjavizdsv
WAS: gtucrlsijwrmwrzvircrmfythigqlkgyybszvmtufahxnswnotkcjzviydsu
WAT: gttcrksiiwrlwryviqcrlfyshifqljgyxbsyvmsufzhxmswmotjcjyvixdst
WAW: gtqcrhsifwriwrvvincrifyphicqlggyubsvvmpufwhxjswjotgcjvviudsq
WAX: gtpcrgsiewrhwruvimcrhfyohibqlfgytbsuvmoufvhxiswiotfcjuvitdsp
WAY: gtocrfsidwrgwrtvilcrgfynhiaqlegysbstvmnufuhxhswhotecjtvisdso
WEB: gplcncseawndwnqveicndfukhexqhbgupboqvikubrhtesseopbcfqvepdol
WED: gpjcnaseywnbwnovegcnbfuihevqhzgunbooviiubphtcsscopzcfovendoj
WEE: gpicnzsexwnawnnvefcnafuhheuqhygumbonvihubohtbssbopycfnvemdoi
WEN: gpzcnqseownrwnevewcnrfuyhelqhpgudboeviyubfhtssssoppcfeveddoz
WET: gptcnkseiwnlwnyveqcnlfushefqhjguxboyvisubzhtmssmopjcfyvexdot
WHA: gmmckdsbbwkewkrvbjckefrlhbyqecgrqblrvfluyshqfspfomcccrvbqdlm
WHO: gmyckpsbnwkqwkdvbvckqfrxhbkqeogrcbldvfxuyehqrspromoccdvbcdly
WHY: gmockfsbdwkgwktvblckgfrnhbaqeegrsbltvfnuyuhqhsphomecctvbsdlo
WIG: glgcjxsavwjywjlvadcjyfqfhasqdwgqkbklvefuxmhpzsozolwcblvakdkg
WIN: glzcjqsaowjrwjevawcjrfqyhalqdpgqdbkeveyuxfhpssosolpcbevaddkz
WIS: glucjlsajwjmwjzvarcjmfqthagqdkgqybkzvetuxahpnsonolkcbzvaydku
WIT: gltcjksaiwjlwjyvaqcjlfqshafqdjgqxbkyvesuxzhpmsomoljcbyvaxdkt
WIZ: glncjesacwjfwjsvakcjffqmhazqddgqrbksvemuxthpgsogoldcbsvardkn
WOE: gficdzsuxwdawdnvufcdafkhhuuqxygkmbenvyhurohjbsibofycvnvumdei
WOG: gfgcdxsuvwdywdlvudcdyfkfhusqxwgkkbelvyfurmhjzsizofwcvlvukdeg
WOK: gfccdtsurwduwdhvuzcdufkbhuoqxsgkgbehvyburihjvsivofscvhvugdec
WON: gfzcdqsuowdrwdevuwcdrfkyhulqxpgkdbeevyyurfhjssisofpcvevuddez
WOO: gfycdpsunwdqwddvuvcdqfkxhukqxogkcbedvyxurehjrsirofocvdvucdey
WOP: gfxcdosumwdpwdcvuucdpfkwhujqxngkbbecvywurdhjqsiqofncvcvubdex
WOS: gfucdlsujwdmwdzvurcdmfkthugqxkgkybezvyturahjnsinofkcvzvuydeu
WOT: gftcdksuiwdlwdyvuqcdlfkshufqxjgkxbeyvysurzhjmsimofjcvyvuxdet
WOW: gfqcdhsufwdiwdvvuncdifkphucqxggkubevvypurwhjjsijofgcvvvuudeq
WRY: gcocafsrdwagwatvrlcagfhnhraqueghsbbtvvnuouhghsfhocecstvrsdbo
WUD: gzjcxasoywxbwxovogcxbfeihovqrzgenbyovsiulphdcsccozzcpovondyj
WYE: gvictzskxwtawtnvkfctafahhkuqnygambunvohuhohzbsybovyclnvkmdui
WYN: gvzctqskowtrwtevkwctrfayhklqnpgadbuevoyuhfhzssysovpclevkdduz
XIS: flubjlrajvjmvjzuarbjmeqtgagpdkfqyakzuettxagpnronnlkbbzuaycku
YAG: etgarxqivuryurltidarydyffisolweykzsltmfsfmfxzqwzmtwajltikbsg
YAH: etfarwqiuurxurkticarxdyefirolveyjzsktmesflfxyqwymtvajktijbsf
YAK: etcartqiruruurhtizarudybfioolseygzshtmbsfifxvqwvmtsajhtigbsc
YAM: etaarrqipursurftixarsdyzfimolqeyezsftmzsfgfxtqwtmtqajftiebsa
YAP: etxaroqimurpurctiuarpdywfijolneybzsctmwsfdfxqqwqmtnajctibbsx
YAR: etvarmqikurnuratisarndyufiholleyzzsatmusfbfxoqwomtlajatizbsv
YAW: etqarhqifuriurvtinaridypficolgeyuzsvtmpsfwfxjqwjmtgajvtiubsq
YAY: etoarfqidurgurttilargdynfiaoleeyszsttmnsfufxhqwhmteajttisbso
YEA: epmandqebuneunrtejanedulfeyohceuqzortilsbsftfqsfmpcafrteqbom
YEH: epfanwqeuunxunktecanxdueferohveujzoktiesblftyqsympvafktejbof
YEN: epzanqqeounrunetewanrduyfelohpeudzoetiysbfftsqssmppafetedboz
YEP: epxanoqemunpuncteuanpduwfejohneubzoctiwsbdftqqsqmpnafctebbox
YES: epuanlqejunmunzteranmdutfegohkeuyzoztitsbaftnqsnmpkafzteybou
YET: eptankqeiunlunyteqanldusfefohjeuxzoytissbzftmqsmmpjafytexbot
YEW: epqanhqefuniunvtenanidupfecohgeuuzovtipsbwftjqsjmpgafvteuboq
YID: eljajaqayujbujotagajbdqifavodzeqnzkoteisxpfpcqocmlzabotanbkj
YIN: elzajqqaoujrujetawajrdqyfalodpeqdzketeysxffpsqosmlpabetadbkz
YIP: elxajoqamujpujctauajpdqwfajodneqbzkctewsxdfpqqoqmlnabctabbkx
YOB: efladcquauddudqtuiadddkkfuxoxbekpzeqtyksrrfjeqiemfbavqtupbel
YOD: efjadaquyudbudotugadbdkifuvoxzeknzeotyisrpfjcqicmfzavotunbej
YOK: efcadtquruduudhtuzadudkbfuooxsekgzehtybsrifjvqivmfsavhtugbec
YOM: efaadrqupudsudftuxadsdkzfumoxqekezeftyzsrgfjtqitmfqavftuebea
YON: efzadqquoudrudetuwadrdkyfuloxpekdzeetyysrffjsqismfpavetudbez
YOU: efsadjquhudkudxtupadkdkrfueoxiekwzextyrsryfjlqilmfiavxtuwbes
YOW: efqadhqufudiudvtunadidkpfucoxgekuzevtypsrwfjjqijmfgavvtuubeq
YUK: ezcaxtqoruxuuxhtozaxudebfooorseegzyhtsbslifdvqcvmzsaphtogbyc
YUM: ezaaxrqopuxsuxftoxaxsdezfomorqeeezyftszslgfdtqctmzqapftoebya
YUP: ezxaxoqomuxpuxctouaxpdewfojorneebzyctswsldfdqqcqmznapctobbyx
ZAG: dtgzrxpivtrytrlsidzrycyfeisnlwdykyslsmfrfmexzpwzltwzjlsikasg
ZAP: dtxzropimtrptrcsiuzrpcyweijnlndybyscsmwrfdexqpwqltnzjcsibasx
ZAS: dtuzrlpijtrmtrzsirzrmcyteignlkdyyyszsmtrfaexnpwnltkzjzsiyasu
ZAX: dtpzrgpietrhtrusimzrhcyoeibnlfdytysusmorfvexipwiltfzjusitasp
ZED: dpjznapeytnbtnosegznbcuieevnhzdunyoosiirbpetcpsclpzzfosenaoj
ZEE: dpiznzpextnatnnsefznacuheeunhydumyonsihrboetbpsblpyzfnsemaoi
ZEK: dpczntpertnutnhsezznucubeeonhsdugyohsibrbietvpsvlpszfhsegaoc
ZEP: dpxznopemtnptncseuznpcuweejnhndubyocsiwrbdetqpsqlpnzfcsebaox
ZIG: dlgzjxpavtjytjlsadzjycqfeasndwdqkyklsefrxmepzpozllwzblsakakg
ZIN: dlzzjqpaotjrtjesawzjrcqyealndpdqdykeseyrxfepsposllpzbesadakz
ZIP: dlxzjopamtjptjcsauzjpcqweajndndqbykcsewrxdepqpoqllnzbcsabakx
ZIT: dltzjkpaitjltjysaqzjlcqseafndjdqxykysesrxzepmpomlljzbysaxakt
ZOA: dfmzddpubtdetdrsujzdeckleuynxcdkqyersylrrsejfpiflfczvrsuqaem
ZOO: dfyzdppuntdqtddsuvzdqckxeuknxodkcyedsyxrreejrpirlfozvdsucaey
ZUZ: dznzxepoctxftxssokzxfcemeoznrdderyysssmrltedgpcglzdzpssorayn
ZZZ: dunzsepjctsftsssjkzsfczmejznmddzrytssnmrgteygpxgludzkssjratn
